Dong,인구_주민등록인구_내국인각세별_Autonomous Gu_Autonomous Gu,인구_주민등록인구_내국인각세별_Households_Households,인구_주민등록인구_내국인각세별_Total_Population ,인구_주민등록인구_내국인각세별_Total_Male,인구_주민등록인구_내국인각세별_Total_Female,인구_주민등록인구_내국인각세별_Korean_Population ,인구_주민등록인구_내국인각세별_Korean_Male,인구_주민등록인구_내국인각세별_Korean_Female,인구_주민등록인구_내국인각세별_Foreigner_Population ,인구_주민등록인구_내국인각세별_Foreigner_Male,인구_주민등록인구_내국인각세별_Foreigner_Female,인구_주민등록인구_내국인각세별_Persons per Households_Persons per Households,인구_주민등록인구_내국인각세별_Person 65 years and over_Person 65 years and over
Sajik-dong,Jongno-gu,4495,10365.0,4881.0,5484,9920,4618,5302,445.0,263.0,182,2.21,1642
Samcheong-dong,Jongno-gu,1555,3421.0,1650.0,1771,3285,1576,1709,136.0,74.0,62,2.11,626
Buam-dong,Jongno-gu,4608,11527.0,5651.0,5876,11247,5538,5709,280.0,113.0,167,2.44,1683
Pyeongchang-dong,Jongno-gu,7376,19752.0,9433.0,10319,19493,9303,10190,259.0,130.0,129,2.64,2765
Muak-dong,Jongno-gu,3229,8664.0,4117.0,4547,8613,4095,4518,51.0,22.0,29,2.67,1177
Gyonam-dong,Jongno-gu,2893,5859.0,2912.0,2947,5738,2860,2878,121.0,52.0,69,1.98,902
Gahoe-dong,Jongno-gu,2373,5413.0,2540.0,2873,5298,2491,2807,115.0,49.0,66,2.23,882
Jongno 1·2·3·4(ilisamsa)-ga-dong,Jongno-gu,5253,8856.0,5136.0,3720,7861,4565,3296,995.0,571.0,424,1.5,1681
Jongno 5·6(oryuk)-ga-dong,Jongno-gu,3140,6311.0,3391.0,2920,5993,3255,2738,318.0,136.0,182,1.91,1007
Ihwa-dong,Jongno-gu,4536,9503.0,4528.0,4975,9048,4323,4725,455.0,205.0,250,1.99,1139
Changsin 1(il)-dong,Jongno-gu,3438,7483.0,3922.0,3561,6536,3476,3060,947.0,446.0,501,1.9,1025
Changsin 2(i)-dong,Jongno-gu,4843,11860.0,5973.0,5887,10843,5524,5319,1017.0,449.0,568,2.24,1481
Changsin 3(sam)-dong,Jongno-gu,3068,8406.0,4210.0,4196,8296,4163,4133,110.0,47.0,63,2.7,1013
Sungin 1(il)-dong,Jongno-gu,3244,7652.0,3830.0,3822,7265,3662,3603,387.0,168.0,219,2.24,947
Sungin 2(i)-dong,Jongno-gu,4954,9728.0,5072.0,4656,9330,4898,4432,398.0,174.0,224,1.88,1418
Cheongunhyoja-dong,Jongno-gu,5939,14906.0,7145.0,7761,14778,7086,7692,128.0,59.0,69,2.49,2095
Hyehwa-dong,Jongno-gu,9148,19588.0,9546.0,10042,17941,8875,9066,1647.0,671.0,976,1.96,2374
Sogong-dong,Jung-gu,687,1820.0,1028.0,792,1352,720,632,468.0,308.0,160,1.97,174
Hoehyeon-dong,Jung-gu,3590,6587.0,3590.0,2997,5902,3219,2683,685.0,371.0,314,1.64,1243
Myeong-dong,Jung-gu,1619,4175.0,2018.0,2157,3359,1487,1872,816.0,531.0,285,2.07,644
Pil-dong,Jung-gu,2404,4872.0,2589.0,2283,4482,2393,2089,390.0,196.0,194,1.86,727
Jangchung-dong,Jung-gu,3014,6310.0,3166.0,3144,5659,2903,2756,651.0,263.0,388,1.88,750
Gwanghui-dong ,Jung-gu,2955,6221.0,3288.0,2933,5408,2905,2503,813.0,383.0,430,1.83,953
Euljiro-dong,Jung-gu,1361,2060.0,1283.0,777,1951,1229,722,109.0,54.0,55,1.43,412
Sindang-dong,Jung-gu,3974,9191.0,4675.0,4516,7776,3996,3780,1415.0,679.0,736,1.96,1146
Dasan-dong,Jung-gu,7203,16712.0,8217.0,8495,16347,8062,8285,365.0,155.0,210,2.27,2177
Yaksu-dong,Jung-gu,7981,19410.0,9353.0,10057,19191,9260,9931,219.0,93.0,126,2.4,2841
Cheonggu-dong,Jung-gu,6535,16003.0,7685.0,8318,15817,7607,8210,186.0,78.0,108,2.42,2176
Sindang 5(o)-dong,Jung-gu,4636,10704.0,5369.0,5335,10431,5254,5177,273.0,115.0,158,2.25,1377
Donghwa-dong,Jung-gu,4405,12126.0,5893.0,6233,11960,5813,6147,166.0,80.0,86,2.72,1422
Hwanghak-dong,Jung-gu,5744,13070.0,6639.0,6431,12273,6265,6008,797.0,374.0,423,2.14,1584
Jungnim-dong,Jung-gu,4859,10438.0,5305.0,5133,10134,5150,4984,304.0,155.0,149,2.09,1607
Huam-dong,Yongsan-gu,8909,20212.0,10041.0,10171,19741,9814,9927,471.0,227.0,244,2.22,2652
Yongsan 2-ga-dong,Yongsan-gu,5941,13713.0,6753.0,6960,12648,6140,6508,1065.0,613.0,452,2.13,1838
Namyeong-dong,Yongsan-gu,5272,8471.0,5042.0,3429,8030,4843,3187,441.0,199.0,242,1.52,1294
Wonhyoro 2(i)-dong,Yongsan-gu,5970,15866.0,7541.0,8325,15679,7464,8215,187.0,77.0,110,2.63,1984
Hyochang-dong,Yongsan-gu,4378,11333.0,5492.0,5841,11170,5421,5749,163.0,71.0,92,2.55,1476
Yongmun-dong,Yongsan-gu,5122,13154.0,6431.0,6723,13009,6364,6645,145.0,67.0,78,2.54,1650
Ichon 1(il)-dong,Yongsan-gu,9799,28267.0,13334.0,14933,26934,12574,14360,1333.0,760.0,573,2.75,3469
Ichon 2(i)-dong,Yongsan-gu,4300,10276.0,4930.0,5346,10220,4909,5311,56.0,21.0,35,2.38,1563
Itaewon 1(il)-dong,Yongsan-gu,4418,9814.0,4716.0,5098,8336,3848,4488,1478.0,868.0,610,1.89,1455
Itaewon 2(i)-dong,Yongsan-gu,5379,11898.0,5649.0,6249,10980,5115,5865,918.0,534.0,384,2.04,1831
Seobinggo-dong,Yongsan-gu,5476,14404.0,6959.0,7445,14028,6785,7243,376.0,174.0,202,2.56,1941
Bogwang-dong,Yongsan-gu,8487,18173.0,8866.0,9307,17306,8404,8902,867.0,462.0,405,2.04,2417
Cheongpa-dong,Yongsan-gu,11347,23720.0,11290.0,12430,22760,10967,11793,960.0,323.0,637,2.01,2856
Wonhyoro 1(il)-dong,Yongsan-gu,5682,12946.0,6427.0,6519,12671,6293,6378,275.0,134.0,141,2.23,1470
Hangangno-dong,Yongsan-gu,7816,16468.0,8247.0,8221,15304,7644,7660,1164.0,603.0,561,1.96,2499
Hannam-dong,Yongsan-gu,11830,25188.0,12171.0,13017,23002,10999,12003,2186.0,1172.0,1014,1.94,3148
Wangsimni 2(i)-dong,Seongdong-gu,6992,17338.0,8566.0,8772,17059,8447,8612,279.0,119.0,160,2.44,1959
Majang-dong,Seongdong-gu,10352,25618.0,12798.0,12820,25073,12537,12536,545.0,261.0,284,2.42,2941
Sageun-dong,Seongdong-gu,6009,11839.0,6154.0,5685,10661,5602,5059,1178.0,552.0,626,1.77,1300
Haengdang 1(il)-dong,Seongdong-gu,7558,18000.0,8874.0,9126,17547,8674,8873,453.0,200.0,253,2.32,2183
Haengdang 2(i)-dong,Seongdong-gu,9572,26832.0,12797.0,14035,26745,12764,13981,87.0,33.0,54,2.79,2832
Eungbong-dong,Seongdong-gu,6419,17463.0,8416.0,9047,17401,8394,9007,62.0,22.0,40,2.71,2095
Geumho 1(il)-ga-dong,Seongdong-gu,6023,15477.0,7544.0,7933,15376,7506,7870,101.0,38.0,63,2.55,1982
Geumho 4(sa)-ga-dong,Seongdong-gu,6186,15082.0,7362.0,7720,14915,7275,7640,167.0,87.0,80,2.41,1706
Seongsu 1(il)-ga1(il)-dong,Seongdong-gu,7300,18387.0,9364.0,9023,17951,9131,8820,436.0,233.0,203,2.46,1737
Seongsu 1(il)-ga2(i)-dong,Seongdong-gu,8093,18721.0,9456.0,9265,18328,9272,9056,393.0,184.0,209,2.26,1819
Seongsu 2(i)-ga1(il)-dong,Seongdong-gu,9045,21294.0,11123.0,10171,20466,10717,9749,828.0,406.0,422,2.26,2199
Seongsu 2(i)-ga 3(sam)-dong,Seongdong-gu,5456,12457.0,6480.0,5977,12039,6229,5810,418.0,251.0,167,2.21,1424
Songjeong-dong,Seongdong-gu,5592,12640.0,6640.0,6000,12095,6392,5703,545.0,248.0,297,2.16,1314
Yongdap-dong,Seongdong-gu,7657,17445.0,9188.0,8257,16497,8735,7762,948.0,453.0,495,2.15,2091
WangsimniDoseon-dong,Seongdong-gu,5841,13132.0,6471.0,6661,12826,6329,6497,306.0,142.0,164,2.2,1853
Geumho 2.3(i.sam)-ga-dong,Seongdong-gu,9433,23568.0,11418.0,12150,23335,11307,12028,233.0,111.0,122,2.47,2935
Oksu-dong,Seongdong-gu,9498,23572.0,11333.0,12239,23334,11216,12118,238.0,117.0,121,2.46,2661
Hwayang-dong,Gwangjin-gu,13553,24241.0,11789.0,12452,21549,10631,10918,2692.0,1158.0,1534,1.59,1970
Gunja-dong,Gwangjin-gu,10232,22163.0,11140.0,11023,21296,10711,10585,867.0,429.0,438,2.08,2292
Junggok 1(il)-dong,Gwangjin-gu,7692,17187.0,8502.0,8685,16692,8292,8400,495.0,210.0,285,2.17,1836
Junggok 2(i)-dong,Gwangjin-gu,9818,23268.0,11387.0,11881,23045,11292,11753,223.0,95.0,128,2.35,2231
Junggok 3(sam)-dong,Gwangjin-gu,8229,19057.0,9602.0,9455,18866,9523,9343,191.0,79.0,112,2.29,1985
Junggok 4(sa)-dong,Gwangjin-gu,12706,32147.0,15971.0,16176,31966,15909,16057,181.0,62.0,119,2.52,3375
Neung-dong,Gwangjin-gu,5634,11420.0,5389.0,6031,11163,5281,5882,257.0,108.0,149,1.98,1194
Guui 1(il)-dong,Gwangjin-gu,10841,23298.0,11257.0,12041,22529,10913,11616,769.0,344.0,425,2.08,2292
Guui 2(i)-dong,Gwangjin-gu,10961,27787.0,13674.0,14113,27427,13551,13876,360.0,123.0,237,2.5,3001
Guui 3(sam)-dong,Gwangjin-gu,11473,29961.0,14571.0,15390,29675,14433,15242,286.0,138.0,148,2.59,2686
Gwangjang-dong,Gwangjin-gu,11908,36959.0,18020.0,18939,36741,17922,18819,218.0,98.0,120,3.09,2774
Jayang 1(il)-dong,Gwangjin-gu,11097,25826.0,12738.0,13088,24044,11890,12154,1782.0,848.0,934,2.17,2613
Jayang 2(i)-dong,Gwangjin-gu,11268,28779.0,14337.0,14442,28483,14190,14293,296.0,147.0,149,2.53,2739
Jayang 3(sam)-dong,Gwangjin-gu,11507,32051.0,15615.0,16436,31696,15461,16235,355.0,154.0,201,2.75,2730
Jayang 4(sa)-dong,Gwangjin-gu,12158,28741.0,14585.0,14156,25107,12845,12262,3634.0,1740.0,1894,2.07,3048
Hoegi-dong,Dongdaemun-gu,5879,12693.0,6022.0,6671,11215,5451,5764,1478.0,571.0,907,1.91,1333
Hwigyeong 1(il)-dong,Dongdaemun-gu,8125,17545.0,8695.0,8850,16497,8255,8242,1048.0,440.0,608,2.03,2181
Hwigyeong 2(i)-dong,Dongdaemun-gu,10666,26357.0,13027.0,13330,25972,12863,13109,385.0,164.0,221,2.44,2839
Cheongnyangni-dong,Dongdaemun-gu,10841,25154.0,12640.0,12514,24221,12154,12067,933.0,486.0,447,2.23,4370
Yongsin-dong,Dongdaemun-gu,15707,33292.0,17209.0,16083,31855,16540,15315,1437.0,669.0,768,2.03,4834
Jegi-dong,Dongdaemun-gu,12982,29165.0,14807.0,14358,27614,14147,13467,1551.0,660.0,891,2.13,4377
Jeonnong 1(il)-dong,Dongdaemun-gu,14153,31257.0,15917.0,15340,30742,15720,15022,515.0,197.0,318,2.17,4436
Jeonnong 2(i)-dong,Dongdaemun-gu,7788,21610.0,10550.0,11060,21335,10450,10885,275.0,100.0,175,2.74,2662
Dapsimni 1(il)-dong,Dongdaemun-gu,8573,20299.0,10150.0,10149,19869,9946,9923,430.0,204.0,226,2.32,2709
Dapsimni 2(i)-dong,Dongdaemun-gu,12149,31934.0,15800.0,16134,31640,15663,15977,294.0,137.0,157,2.6,4017
Jangan 1(il)-dong,Dongdaemun-gu,14976,37949.0,19045.0,18904,37212,18737,18475,737.0,308.0,429,2.48,4049
Jangan 2(i)-dong,Dongdaemun-gu,12812,32759.0,16581.0,16178,32497,16486,16011,262.0,95.0,167,2.54,3496
Imun 1(il)-dong,Dongdaemun-gu,15387,33348.0,16476.0,16872,30964,15519,15445,2384.0,957.0,1427,2.01,3966
Imun 2(i)-dong,Dongdaemun-gu,8756,23523.0,11599.0,11924,23085,11413,11672,438.0,186.0,252,2.64,2718
Myeonmok 2(i)-dong,Jungnang-gu,12097,28409.0,14274.0,14135,27992,14101,13891,417.0,173.0,244,2.31,3116
Myeonmok 4(sa)-dong,Jungnang-gu,9799,22567.0,11198.0,11369,22350,11118,11232,217.0,80.0,137,2.28,2630
Myeonmok 5(o)-dong,Jungnang-gu,6053,14190.0,7251.0,6939,14028,7204,6824,162.0,47.0,115,2.32,1637
Myeonmok 7(chil)-dong,Jungnang-gu,10648,25593.0,12789.0,12804,25382,12715,12667,211.0,74.0,137,2.38,2972
Sangbong 1(il)-dong,Jungnang-gu,9301,25808.0,12738.0,13070,25580,12653,12927,228.0,85.0,143,2.75,2580
Sangbong 2(i)-dong,Jungnang-gu,9219,18602.0,9450.0,9152,18348,9344,9004,254.0,106.0,148,1.99,2257
Junghwa 1(il)-dong,Jungnang-gu,8346,21713.0,10781.0,10932,21442,10674,10768,271.0,107.0,164,2.57,2251
Junghwa 2(i)-dong,Jungnang-gu,14517,30885.0,15946.0,14939,30367,15729,14638,518.0,217.0,301,2.09,3875
Muk 1(il)-dong,Jungnang-gu,13912,36553.0,17945.0,18608,36336,17862,18474,217.0,83.0,134,2.61,3960
Muk 2(i)-dong,Jungnang-gu,8493,20164.0,10104.0,10060,20028,10062,9966,136.0,42.0,94,2.36,2364
Mangu 3(sam)-dong,Jungnang-gu,8318,19370.0,9755.0,9615,19219,9709,9510,151.0,46.0,105,2.31,2271
Sinnae 1(il)-dong,Jungnang-gu,11011,32242.0,15892.0,16350,32090,15825,16265,152.0,67.0,85,2.91,3516
Sinnae 2(i)-dong,Jungnang-gu,9286,25124.0,12234.0,12890,25039,12200,12839,85.0,34.0,51,2.7,2646
Myeonmokbon-dong,Jungnang-gu,16285,37087.0,18469.0,18618,36406,18232,18174,681.0,237.0,444,2.24,4118
Myeonmok 3.8(sam.pal)-dong,Jungnang-gu,12663,29281.0,14621.0,14660,28986,14509,14477,295.0,112.0,183,2.29,3497
Mangubon-dong,Jungnang-gu,14793,35040.0,17667.0,17373,34673,17535,17138,367.0,132.0,235,2.34,4088
Donam 1(il)-dong,Seongbuk-gu,6194,16578.0,7980.0,8598,16408,7914,8494,170.0,66.0,104,2.65,2071
Donam 2(i)-dong,Seongbuk-gu,7977,23756.0,11458.0,12298,23686,11428,12258,70.0,30.0,40,2.97,2414
Anam-dong,Seongbuk-gu,9006,18360.0,9224.0,9136,16853,8557,8296,1507.0,667.0,840,1.87,1945
Bomun-dong,Seongbuk-gu,6732,14356.0,7047.0,7309,14026,6914,7112,330.0,133.0,197,2.08,1817
Jeongneung 1(il)-dong,Seongbuk-gu,7553,20396.0,9819.0,10577,20074,9704,10370,322.0,115.0,207,2.66,2485
Jeongneung 2(i)-dong,Seongbuk-gu,9301,24396.0,12100.0,12296,24268,12040,12228,128.0,60.0,68,2.61,3177
Jeongneung 3(sam)-dong,Seongbuk-gu,7944,18542.0,9233.0,9309,17701,8839,8862,841.0,394.0,447,2.23,2705
Jeongneung 4(sa)-dong,Seongbuk-gu,10964,28243.0,13850.0,14393,28015,13759,14256,228.0,91.0,137,2.56,3469
Gireum 1(il)-dong,Seongbuk-gu,12785,37561.0,18253.0,19308,37337,18167,19170,224.0,86.0,138,2.92,3415
Gireum 2(i)-dong,Seongbuk-gu,9027,21068.0,10367.0,10701,20821,10259,10562,247.0,108.0,139,2.31,2751
Wolgok 1(il)-dong,Seongbuk-gu,10948,29323.0,14493.0,14830,29041,14367,14674,282.0,126.0,156,2.65,3391
Wolgok 2(i)-dong,Seongbuk-gu,8881,21871.0,10763.0,11108,21559,10624,10935,312.0,139.0,173,2.43,2738
Jangwi 1(il)-dong,Seongbuk-gu,10214,25959.0,12868.0,13091,25663,12763,12900,296.0,105.0,191,2.51,3251
Jangwi 2(i)-dong,Seongbuk-gu,9204,22582.0,11344.0,11238,22369,11256,11113,213.0,88.0,125,2.43,3063
Jangwi 3(sam)-dong,Seongbuk-gu,7822,19116.0,9788.0,9328,18870,9693,9177,246.0,95.0,151,2.41,2620
Seongbuk-dong,Seongbuk-gu,8614,19549.0,9322.0,10227,18994,9090,9904,555.0,232.0,323,2.21,2852
Samseon-dong,Seongbuk-gu,12684,28853.0,14026.0,14827,28288,13773,14515,565.0,253.0,312,2.23,3565
Dongseon-dong,Seongbuk-gu,8842,17145.0,7591.0,9554,16597,7369,9228,548.0,222.0,326,1.88,2039
Jongam-dong,Seongbuk-gu,17472,43890.0,21759.0,22131,43066,21438,21628,824.0,321.0,503,2.46,5008
Seokgwan-dong,Seongbuk-gu,15723,37825.0,18956.0,18869,37130,18676,18454,695.0,280.0,415,2.36,4797
Beon 1(il)-dong,Gangbuk-gu,9727,21154.0,10436.0,10718,20785,10307,10478,369.0,129.0,240,2.14,2714
Beon 2(i)-dong,Gangbuk-gu,7848,19681.0,9688.0,9993,19580,9655,9925,101.0,33.0,68,2.49,2919
Beon 3(sam)-dong,Gangbuk-gu,7790,21177.0,10231.0,10946,21116,10217,10899,61.0,14.0,47,2.71,3500
Suyu 1(il)-dong,Gangbuk-gu,9920,23250.0,11656.0,11594,22908,11528,11380,342.0,128.0,214,2.31,3217
Suyu 2(i)-dong,Gangbuk-gu,9165,23251.0,11470.0,11781,23120,11438,11682,131.0,32.0,99,2.52,3535
Suyu 3(sam)-dong,Gangbuk-gu,11028,24394.0,12098.0,12296,24063,11972,12091,331.0,126.0,205,2.18,3397
Samyang-dong,Gangbuk-gu,13024,31551.0,15730.0,15821,31407,15679,15728,144.0,51.0,93,2.41,4066
Mia-dong,Gangbuk-gu,10497,24174.0,11871.0,12303,23431,11585,11846,743.0,286.0,457,2.23,3167
Songjung-dong,Gangbuk-gu,13878,33516.0,16375.0,17141,33190,16237,16953,326.0,138.0,188,2.39,4597
Songcheon-dong,Gangbuk-gu,13979,32079.0,16023.0,16056,31766,15887,15879,313.0,136.0,177,2.27,4587
Samgaksan-dong,Gangbuk-gu,12143,35058.0,17094.0,17964,34991,17070,17921,67.0,24.0,43,2.88,3019
Ui-dong,Gangbuk-gu,8823,21487.0,10610.0,10877,21365,10561,10804,122.0,49.0,73,2.42,3478
Insu-dong,Gangbuk-gu,13910,33774.0,16574.0,17200,33571,16504,17067,203.0,70.0,133,2.41,5138
Ssangmun 1(il)-dong,Dobong-gu,8603,22300.0,10882.0,11418,22075,10819,11256,225.0,63.0,162,2.57,3132
Ssangmun 2(i)-dong,Dobong-gu,8503,21552.0,10541.0,11011,21436,10498,10938,116.0,43.0,73,2.52,2711
Ssangmun 3(sam)-dong,Dobong-gu,7563,18577.0,9112.0,9465,18431,9061,9370,146.0,51.0,95,2.44,2492
Ssangmun 4(sa)-dong,Dobong-gu,7378,21625.0,10452.0,11173,21578,10433,11145,47.0,19.0,28,2.92,2029
Banghak 1(il)-dong,Dobong-gu,12562,32394.0,16276.0,16118,32138,16179,15959,256.0,97.0,159,2.56,3745
Banghak 2(i)-dong,Dobong-gu,9831,23998.0,12129.0,11869,23811,12068,11743,187.0,61.0,126,2.42,3064
Banghak 3(sam)-dong,Dobong-gu,10787,31897.0,15630.0,16267,31833,15607,16226,64.0,23.0,41,2.95,3182
Chang 1(il)-dong,Dobong-gu,10976,28695.0,13953.0,14742,28430,13832,14598,265.0,121.0,144,2.59,3285
Chang 2(i)-dong,Dobong-gu,11841,31651.0,15631.0,16020,31429,15518,15911,222.0,113.0,109,2.65,3434
Chang 3(sam)-dong,Dobong-gu,6684,16083.0,8093.0,7990,16003,8071,7932,80.0,22.0,58,2.39,2002
Chang 4(sa)-dong,Dobong-gu,10881,30786.0,14942.0,15844,30725,14920,15805,61.0,22.0,39,2.82,3069
Chang 5(o)-dong,Dobong-gu,10010,27772.0,13621.0,14151,27626,13563,14063,146.0,58.0,88,2.76,2912
Dobong 1(il)-dong,Dobong-gu,10440,24429.0,12411.0,12018,24243,12348,11895,186.0,63.0,123,2.32,4095
Dobong 2(i)-dong,Dobong-gu,11818,31103.0,15395.0,15708,30995,15358,15637,108.0,37.0,71,2.62,4438
Wolgye 1(il)-dong,Nowon-gu,9369,23203.0,11846.0,11357,22708,11604,11104,495.0,242.0,253,2.42,2849
Wolgye 2(i)-dong,Nowon-gu,12099,30313.0,14746.0,15567,30120,14677,15443,193.0,69.0,124,2.49,3950
Wolgye 3(sam)-dong,Nowon-gu,13428,35897.0,17515.0,18382,35757,17465,18292,140.0,50.0,90,2.66,4116
Gongneung 2(i)-dong,Nowon-gu,17203,46816.0,23326.0,23490,46210,23066,23144,606.0,260.0,346,2.69,3912
Hagye 1(il)-dong,Nowon-gu,11337,30706.0,14856.0,15850,30565,14781,15784,141.0,75.0,66,2.7,3226
Hagye 2(i)-dong,Nowon-gu,8688,25791.0,12550.0,13241,25745,12526,13219,46.0,24.0,22,2.96,2356
Junggyebon-dong,Nowon-gu,9870,29796.0,14689.0,15107,29641,14613,15028,155.0,76.0,79,3,2296
Junggye 1(il)-dong,Nowon-gu,9485,30500.0,15019.0,15481,30415,14981,15434,85.0,38.0,47,3.21,1927
Junggye 4(sa)-dong,Nowon-gu,8194,22515.0,11023.0,11492,22431,10994,11437,84.0,29.0,55,2.74,2671
Sanggye 1(il)-dong,Nowon-gu,15784,44307.0,21822.0,22485,44045,21716,22329,262.0,106.0,156,2.79,4912
Sanggye 2(i)-dong,Nowon-gu,8570,22616.0,11167.0,11449,22485,11116,11369,131.0,51.0,80,2.62,2362
Sanggye 5(o)-dong,Nowon-gu,9499,24244.0,11832.0,12412,24118,11782,12336,126.0,50.0,76,2.54,2910
Sanggye 8(pal)-dong,Nowon-gu,9513,27162.0,13081.0,14081,27119,13073,14046,43.0,8.0,35,2.85,2121
Sanggye 9(gu)-dong,Nowon-gu,8820,24694.0,11979.0,12715,24626,11961,12665,68.0,18.0,50,2.79,2232
Sanggye 10(sip)-dong,Nowon-gu,7736,20557.0,9668.0,10889,20512,9656,10856,45.0,12.0,33,2.65,1805
Sanggye 3.4(sam.sa)-dong,Nowon-gu,16116,38835.0,19530.0,19305,38585,19444,19141,250.0,86.0,164,2.39,5845
Sanggye 6.7(yuk.chil)-dong,Nowon-gu,14284,36934.0,17427.0,19507,36762,17353,19409,172.0,74.0,98,2.57,3395
Junggye 2.3(i.sam)-dong,Nowon-gu,15631,42085.0,19849.0,22236,41939,19790,22149,146.0,59.0,87,2.68,5487
Gongneung 1(il)-dong,Nowon-gu,16913,40434.0,19845.0,20589,40057,19672,20385,377.0,173.0,204,2.37,4229
Nokbeon-dong,Eunpyeong-gu,14612,33455.0,16201.0,17254,32956,15977,16979,499.0,224.0,275,2.26,4599
Bulgwang 1(il)-dong,Eunpyeong-gu,16801,42318.0,20469.0,21849,41935,20298,21637,383.0,171.0,212,2.5,5368
Galhyeon 1(il)-dong,Eunpyeong-gu,10959,26469.0,13079.0,13390,26224,12983,13241,245.0,96.0,149,2.39,3313
Galhyeon 2(i)-dong,Eunpyeong-gu,11338,29220.0,14217.0,15003,28955,14099,14856,265.0,118.0,147,2.55,3248
Gusan-dong,Eunpyeong-gu,12261,34123.0,17435.0,16688,33900,17348,16552,223.0,87.0,136,2.76,4335
Daejo-dong,Eunpyeong-gu,14414,32497.0,15532.0,16965,32152,15383,16769,345.0,149.0,196,2.23,4215
Eungam 1(il)-dong,Eunpyeong-gu,13275,32144.0,15628.0,16516,31770,15480,16290,374.0,148.0,226,2.39,3922
Eungam 2(i)-dong,Eunpyeong-gu,10919,26978.0,13387.0,13591,26803,13308,13495,175.0,79.0,96,2.45,3330
Sinsa 1(il)-dong,Eunpyeong-gu,10991,28450.0,13892.0,14558,28205,13796,14409,245.0,96.0,149,2.57,3261
Sinsa 2(i)-dong,Eunpyeong-gu,8941,22966.0,11523.0,11443,22836,11475,11361,130.0,48.0,82,2.55,2661
Jeungsan-dong,Eunpyeong-gu,8311,21046.0,10520.0,10526,20877,10452,10425,169.0,68.0,101,2.51,2683
Susaek-dong,Eunpyeong-gu,7942,19625.0,9854.0,9771,19425,9784,9641,200.0,70.0,130,2.45,2798
Jingwan-dong,Eunpyeong-gu,16381,51478.0,24747.0,26731,51308,24684,26624,170.0,63.0,107,3.13,5321
Bulgwang 2(i)-dong,Eunpyeong-gu,13151,30403.0,15002.0,15401,30132,14894,15238,271.0,108.0,163,2.29,4304
Eungam 3(sam)-dong,Eunpyeong-gu,12226,27923.0,13775.0,14148,27636,13673,13963,287.0,102.0,185,2.26,3955
Yeokchon-dong,Eunpyeong-gu,19343,49670.0,23972.0,25698,49240,23746,25494,430.0,226.0,204,2.55,5672
Cheonyeon-dong,Seodaemun-gu,8601,20489.0,9942.0,10547,20264,9835,10429,225.0,107.0,118,2.36,2880
Hongje 1(il)-dong,Seodaemun-gu,11258,27392.0,13192.0,14200,26969,13006,13963,423.0,186.0,237,2.4,3803
Hongje 3(sam)-dong,Seodaemun-gu,8335,20222.0,9884.0,10338,20048,9801,10247,174.0,83.0,91,2.41,3121
Hongje 2(i)-dong,Seodaemun-gu,6081,15842.0,7563.0,8279,15695,7505,8190,147.0,58.0,89,2.58,2068
Hongeun 1(il)-dong,Seodaemun-gu,10376,26416.0,12932.0,13484,26101,12798,13303,315.0,134.0,181,2.52,3782
Hongeun 2(i)-dong,Seodaemun-gu,12077,30217.0,14862.0,15355,29609,14579,15030,608.0,283.0,325,2.45,3981
Namgajwa 1(il)-dong,Seodaemun-gu,1784,3916.0,1980.0,1936,3797,1925,1872,119.0,55.0,64,2.13,684
Namgajwa 2(i)-dong,Seodaemun-gu,12819,30867.0,15199.0,15668,30326,14973,15353,541.0,226.0,315,2.37,4236
Bukgajwa 1(il)-dong,Seodaemun-gu,6903,19323.0,9513.0,9810,19159,9440,9719,164.0,73.0,91,2.78,2050
Bukgajwa 2(i)-dong,Seodaemun-gu,13633,34237.0,16823.0,17414,33982,16738,17244,255.0,85.0,170,2.49,4358
Chunghyeon-dong,Seodaemun-gu,9219,20822.0,10100.0,10722,20005,9843,10162,817.0,257.0,560,2.17,2907
Bugahyeon-dong,Seodaemun-gu,4929,11030.0,5383.0,5647,10735,5239,5496,295.0,144.0,151,2.18,1498
Sinchon-dong,Seodaemun-gu,10884,21558.0,9761.0,11797,18376,8652,9724,3182.0,1109.0,2073,1.69,2049
Yeonhui-dong,Seodaemun-gu,18826,43174.0,21013.0,22161,40680,19838,20842,2494.0,1175.0,1319,2.16,5706
Yonggang-dong,Mapo-gu,7628,19238.0,9300.0,9938,18887,9096,9791,351.0,204.0,147,2.48,2181
Daeheung-dong,Mapo-gu,8301,15789.0,7572.0,8217,14092,6943,7149,1697.0,629.0,1068,1.7,1928
Yeomni-dong,Mapo-gu,8028,17891.0,8790.0,9101,17307,8540,8767,584.0,250.0,334,2.16,2297
Sinsu-dong,Mapo-gu,9154,22226.0,10988.0,11238,21735,10757,10978,491.0,231.0,260,2.37,2641
Seogyo-dong,Mapo-gu,15953,29961.0,13803.0,16158,28813,13340,15473,1148.0,463.0,685,1.81,3227
Hapjeong-dong,Mapo-gu,9196,20442.0,9935.0,10507,20204,9821,10383,238.0,114.0,124,2.2,2229
Mangwon 1(il)-dong,Mapo-gu,10552,24360.0,11860.0,12500,24011,11707,12304,349.0,153.0,196,2.28,2782
Mangwon 2(i)-dong,Mapo-gu,8173,21191.0,10279.0,10912,21010,10215,10795,181.0,64.0,117,2.57,2405
Yeonnam-dong,Mapo-gu,9217,20224.0,9728.0,10496,19126,9184,9942,1098.0,544.0,554,2.08,2468
Seongsan 1(il)-dong,Mapo-gu,9175,21521.0,10387.0,11134,21198,10244,10954,323.0,143.0,180,2.31,2459
Seongsan 2(i)-dong,Mapo-gu,15607,40944.0,19871.0,21073,40750,19786,20964,194.0,85.0,109,2.61,4513
Sangam-dong,Mapo-gu,11316,33585.0,16491.0,17094,33037,16214,16823,548.0,277.0,271,2.92,3134
Dohwa-dong,Mapo-gu,9446,23837.0,11475.0,12362,23472,11286,12186,365.0,189.0,176,2.48,3200
Seogang-dong,Mapo-gu,11254,25478.0,12170.0,13308,24978,11938,13040,500.0,232.0,268,2.22,2451
gongdeok-dong,Mapo-gu,15943,37311.0,18160.0,19151,36693,17870,18823,618.0,290.0,328,2.3,4794
Ahyeon-dong,Mapo-gu,8048,19177.0,9388.0,9789,18691,9148,9543,486.0,240.0,246,2.32,2428
Mok 1(il)-dong,Yangcheon-gu,10636,33172.0,16143.0,17029,32913,16014,16899,259.0,129.0,130,3.09,2125
Mok 2(i)-dong,Yangcheon-gu,12212,31899.0,15741.0,16158,31672,15646,16026,227.0,95.0,132,2.59,2804
Mok 3(sam)-dong,Yangcheon-gu,9213,23205.0,11412.0,11793,23046,11346,11700,159.0,66.0,93,2.5,2255
Mok 4(sa)-dong,Yangcheon-gu,10008,28784.0,14337.0,14447,28611,14269,14342,173.0,68.0,105,2.86,2255
Sinwol 1(il)-dong,Yangcheon-gu,10444,24956.0,12736.0,12220,24488,12567,11921,468.0,169.0,299,2.34,2617
Sinwol 2(i)-dong,Yangcheon-gu,7905,21369.0,10635.0,10734,21203,10574,10629,166.0,61.0,105,2.68,2254
Sinwol 3(sam)-dong,Yangcheon-gu,8069,17839.0,9309.0,8530,17615,9224,8391,224.0,85.0,139,2.18,2008
Sinwol 4(sa)-dong,Yangcheon-gu,6811,19449.0,9662.0,9787,19384,9645,9739,65.0,17.0,48,2.85,1900
Sinwol 5(o)-dong,Yangcheon-gu,6271,16426.0,8091.0,8335,16284,8029,8255,142.0,62.0,80,2.6,1623
Sinwol 6(yuk)-dong,Yangcheon-gu,5012,12814.0,6498.0,6316,12753,6474,6279,61.0,24.0,37,2.54,1390
Sinwol 7(chil)-dong,Yangcheon-gu,9379,25095.0,12477.0,12618,24956,12428,12528,139.0,49.0,90,2.66,2830
Sinjeong 1(il)-dong,Yangcheon-gu,6496,20120.0,9877.0,10243,19652,9647,10005,468.0,230.0,238,3.03,1667
Sinjeong 2(i)-dong,Yangcheon-gu,7443,22513.0,11169.0,11344,22321,11076,11245,192.0,93.0,99,3,1865
Sinjeong 3(sam)-dong,Yangcheon-gu,20917,58109.0,28752.0,29357,57222,28319,28903,887.0,433.0,454,2.74,5295
Sinjeong 6(yuk)-dong,Yangcheon-gu,8456,26987.0,13202.0,13785,26943,13184,13759,44.0,18.0,26,3.19,1728
Sinjeong 7(chil)-dong,Yangcheon-gu,11753,33062.0,16370.0,16692,32839,16259,16580,223.0,111.0,112,2.79,3424
Mok 5(o)-dong,Yangcheon-gu,14045,45539.0,22678.0,22861,45452,22639,22813,87.0,39.0,48,3.24,2973
Sinjeong 4(sa)-dong,Yangcheon-gu,15746,37585.0,18586.0,18999,37021,18339,18682,564.0,247.0,317,2.35,3925
Yeomchang-dong,Gangseo-gu,14465,42639.0,20981.0,21658,42485,20912,21573,154.0,69.0,85,2.94,2990
Deungchon 1(il)-dong,Gangseo-gu,9860,22971.0,11120.0,11851,22492,10878,11614,479.0,242.0,237,2.28,2086
Deungchon 2(i)-dong,Gangseo-gu,8025,22198.0,11118.0,11080,22102,11079,11023,96.0,39.0,57,2.75,2016
Deungchon 3(sam)-dong,Gangseo-gu,14736,37375.0,17864.0,19511,37213,17793,19420,162.0,71.0,91,2.53,4452
Hwagokbon-dong,Gangseo-gu,14934,37214.0,18236.0,18978,36909,18117,18792,305.0,119.0,186,2.47,3241
Hwagok 2(i)-dong,Gangseo-gu,8122,20622.0,10137.0,10485,20417,10058,10359,205.0,79.0,126,2.51,1950
Hwagok 3(sam)-dong,Gangseo-gu,9039,24189.0,11827.0,12362,24029,11751,12278,160.0,76.0,84,2.66,2620
Hwagok 4(sa)-dong,Gangseo-gu,9752,23620.0,11736.0,11884,23335,11606,11729,285.0,130.0,155,2.39,2411
Hwagok 6(yuk)-dong,Gangseo-gu,10232,25844.0,12768.0,13076,25619,12655,12964,225.0,113.0,112,2.5,2405
Hwagok 8(pal)-dong,Gangseo-gu,10873,27803.0,13558.0,14245,27492,13429,14063,311.0,129.0,182,2.53,2834
Gayang 1(il)-dong,Gangseo-gu,7228,20499.0,10275.0,10224,20272,10162,10110,227.0,113.0,114,2.8,1744
Gayang 2(i)-dong,Gangseo-gu,7899,17735.0,8541.0,9194,17623,8503,9120,112.0,38.0,74,2.23,2614
Gayang 3(sam)-dong,Gangseo-gu,7856,18722.0,8948.0,9774,18585,8893,9692,137.0,55.0,82,2.37,2477
Balsan 1(il)-dong,Gangseo-gu,11202,33264.0,15929.0,17335,33093,15852,17241,171.0,77.0,94,2.95,2709
Gonghang-dong,Gangseo-gu,10074,22474.0,11707.0,10767,21370,10875,10495,1104.0,832.0,272,2.12,2529
Banghwa 1(il)-dong,Gangseo-gu,11753,31170.0,15618.0,15552,30746,15414,15332,424.0,204.0,220,2.62,3241
Banghwa 2(i)-dong,Gangseo-gu,11275,26130.0,12865.0,13265,25874,12737,13137,256.0,128.0,128,2.29,3405
Banghwa 3(sam)-dong,Gangseo-gu,11420,27315.0,13176.0,14139,27169,13110,14059,146.0,66.0,80,2.38,3432
Hwagok 1(il)-dong,Gangseo-gu,22261,52830.0,26264.0,26566,51654,25758,25896,1176.0,506.0,670,2.32,5479
Ujangsan-dong,Gangseo-gu,14159,39741.0,19295.0,20446,39600,19235,20365,141.0,60.0,81,2.8,3252
Sindorim-dong,Guro-gu,13125,38303.0,18879.0,19424,37969,18695,19274,334.0,184.0,150,2.89,3093
Guro 1(il)-dong,Guro-gu,7895,23142.0,11553.0,11589,22879,11417,11462,263.0,136.0,127,2.9,1630
Guro 3(sam)-dong,Guro-gu,14109,29136.0,14785.0,14351,27862,14114,13748,1274.0,671.0,603,1.97,2446
Guro 4(sa)-dong,Guro-gu,11849,30380.0,15320.0,15060,26211,13144,13067,4169.0,2176.0,1993,2.21,3337
Guro 5(o)-dong,Guro-gu,13542,35424.0,17742.0,17682,31962,15891,16071,3462.0,1851.0,1611,2.36,3362
Gocheok 1(il)-dong,Guro-gu,9521,25564.0,12870.0,12694,25226,12705,12521,338.0,165.0,173,2.65,2834
Gocheok 2(i)-dong,Guro-gu,11945,31561.0,15913.0,15648,31191,15749,15442,370.0,164.0,206,2.61,3360
Gaebong 2(i)-dong,Guro-gu,12652,35209.0,17411.0,17798,34947,17293,17654,262.0,118.0,144,2.76,3810
Gaebong 3(sam)-dong,Guro-gu,8494,22614.0,11305.0,11309,22387,11204,11183,227.0,101.0,126,2.64,2480
Oryu 1(il)-dong,Guro-gu,8688,21471.0,10677.0,10794,20960,10431,10529,511.0,246.0,265,2.41,2541
Oryu 2(i)-dong,Guro-gu,14610,41154.0,20564.0,20590,40547,20281,20266,607.0,283.0,324,2.78,4474
Sugung-dong,Guro-gu,9734,26071.0,13110.0,12961,25800,12959,12841,271.0,151.0,120,2.65,2738
Garibong-dong,Guro-gu,7360,20057.0,11012.0,9045,13315,7272,6043,6742.0,3740.0,3002,1.81,2056
Guro 2(i)-dong,Guro-gu,14791,39473.0,20231.0,19242,31948,16273,15675,7525.0,3958.0,3567,2.16,4631
Gaebong 1(il)-dong,Guro-gu,13362,34536.0,17359.0,17177,33697,16970,16727,839.0,389.0,450,2.52,3996
Gasan-dong,Geumcheon-gu,10981,23715.0,13463.0,10252,19446,10999,8447,4269.0,2464.0,1805,1.77,2016
Doksan 1(il)-dong,Geumcheon-gu,14451,35217.0,18577.0,16640,31909,16789,15120,3308.0,1788.0,1520,2.21,3646
Doksan 2(i)-dong,Geumcheon-gu,9811,24130.0,12251.0,11879,22799,11600,11199,1331.0,651.0,680,2.32,2350
Doksan 3(sam)-dong,Geumcheon-gu,12725,31753.0,16251.0,15502,28046,14297,13749,3707.0,1954.0,1753,2.2,3216
Doksan 4(sa)-dong,Geumcheon-gu,8256,20174.0,10290.0,9884,18919,9635,9284,1255.0,655.0,600,2.29,1951
Siheung 1(il)-dong,Geumcheon-gu,15247,38551.0,19527.0,19024,36241,18352,17889,2310.0,1175.0,1135,2.38,4261
Siheung 2(i)-dong,Geumcheon-gu,8681,25034.0,12332.0,12702,24951,12291,12660,83.0,41.0,42,2.87,2827
Siheung 3(sam)-dong,Geumcheon-gu,5007,12933.0,6538.0,6395,12813,6489,6324,120.0,49.0,71,2.56,1661
Siheung 4(sa)-dong,Geumcheon-gu,9440,24349.0,12208.0,12141,23821,11969,11852,528.0,239.0,289,2.52,2657
Siheung 5(o)-dong,Geumcheon-gu,9679,23913.0,11981.0,11932,23446,11761,11685,467.0,220.0,247,2.42,3126
Yeouido-dong,Yeongdeungpo-gu,12469,34275.0,16384.0,17891,33776,16093,17683,499.0,291.0,208,2.71,4748
Dangsan 1(il)-dong,Yeongdeungpo-gu,9330,21214.0,10593.0,10621,20650,10324,10326,564.0,269.0,295,2.21,2590
Dangsan2(i)-dong,Yeongdeungpo-gu,14714,35112.0,16945.0,18167,34675,16728,17947,437.0,217.0,220,2.36,3522
Yangpyeong 1(il)-dong,Yeongdeungpo-gu,7365,17568.0,8875.0,8693,17210,8688,8522,358.0,187.0,171,2.34,1960
Yangpyeong 2(i)-dong,Yeongdeungpo-gu,8821,22580.0,11430.0,11150,22194,11231,10963,386.0,199.0,187,2.52,1945
Singil 1(il)-dong,Yeongdeungpo-gu,10019,23587.0,11938.0,11649,20664,10422,10242,2923.0,1516.0,1407,2.06,2958
Singil 3(sam)-dong,Yeongdeungpo-gu,6886,17613.0,8858.0,8755,16449,8270,8179,1164.0,588.0,576,2.39,2095
Singil 4(sa)-dong,Yeongdeungpo-gu,5473,13758.0,6950.0,6808,12484,6298,6186,1274.0,652.0,622,2.28,1755
Singil 5(o)-dong,Yeongdeungpo-gu,6967,19075.0,9636.0,9439,16180,8102,8078,2895.0,1534.0,1361,2.32,2239
Singil 6(yuk)-dong,Yeongdeungpo-gu,9541,24705.0,12266.0,12439,23007,11385,11622,1698.0,881.0,817,2.41,2815
Singil 7(chil)-dong,Yeongdeungpo-gu,5956,15746.0,7923.0,7823,15322,7698,7624,424.0,225.0,199,2.57,1460
Daerim 1(il)-dong,Yeongdeungpo-gu,7232,19666.0,9987.0,9679,16277,8184,8093,3389.0,1803.0,1586,2.25,2239
Daerim 2(i)-dong,Yeongdeungpo-gu,7936,25447.0,12942.0,12505,17097,8511,8586,8350.0,4431.0,3919,2.15,2626
Daerim 3(sam)-dong,Yeongdeungpo-gu,11536,31926.0,16131.0,15795,28083,14168,13915,3843.0,1963.0,1880,2.43,3074
Yeongdeungpobon-dong,Yeongdeungpo-gu,10907,27689.0,14069.0,13620,24929,12636,12293,2760.0,1433.0,1327,2.29,2903
Yeongdeungpo-dong,Yeongdeungpo-gu,11507,20629.0,11686.0,8943,19513,11116,8397,1116.0,570.0,546,1.7,2591
Dorim-dong,Yeongdeungpo-gu,8942,21693.0,11094.0,10599,18608,9492,9116,3085.0,1602.0,1483,2.08,2410
Mullae-dong,Yeongdeungpo-gu,12495,32805.0,16395.0,16410,32500,16225,16275,305.0,170.0,135,2.6,3471
Noryangjin 2(i)-dong,Dongjak-gu,7464,16440.0,8263.0,8177,15409,7758,7651,1031.0,505.0,526,2.06,2165
Sangdo 1(il)-dong,Dongjak-gu,19321,45022.0,22166.0,22856,43790,21563,22227,1232.0,603.0,629,2.27,4887
Sangdo 2(i)-dong,Dongjak-gu,11111,26220.0,12729.0,13491,25859,12552,13307,361.0,177.0,184,2.33,3155
Sangdo 3(sam)-dong,Dongjak-gu,10152,25056.0,12244.0,12812,24767,12118,12649,289.0,126.0,163,2.44,3238
Sangdo 4(sa)-dong,Dongjak-gu,11940,29980.0,14911.0,15069,29656,14772,14884,324.0,139.0,185,2.48,3586
Sadang 1(il)-dong,Dongjak-gu,11284,24405.0,11778.0,12627,23519,11369,12150,886.0,409.0,477,2.08,2588
Sadang 3(sam)-dong,Dongjak-gu,10362,26291.0,12945.0,13346,26019,12823,13196,272.0,122.0,150,2.51,3130
Sadang 4(sa)-dong,Dongjak-gu,6335,15311.0,7521.0,7790,15140,7436,7704,171.0,85.0,86,2.39,1869
Sadang 5(o)-dong,Dongjak-gu,6313,15566.0,7769.0,7797,15378,7671,7707,188.0,98.0,90,2.44,1727
Daebang-dong,Dongjak-gu,15764,40797.0,19833.0,20964,40406,19643,20763,391.0,190.0,201,2.56,4186
Sindaebang 1(il)-dong,Dongjak-gu,10085,28717.0,14113.0,14604,25992,12779,13213,2725.0,1334.0,1391,2.58,2767
Sindaebang 2(i)-dong,Dongjak-gu,8450,21459.0,10524.0,10935,21183,10398,10785,276.0,126.0,150,2.51,2316
Heukseok-dong,Dongjak-gu,16128,38741.0,18962.0,19779,37268,18383,18885,1473.0,579.0,894,2.31,5068
Noryangjin 1(il)-dong,Dongjak-gu,14447,34878.0,17439.0,17439,34372,17205,17167,506.0,234.0,272,2.38,4369
Sadang 2(i)-dong,Dongjak-gu,12663,31549.0,15452.0,16097,30981,15201,15780,568.0,251.0,317,2.45,3782
Boramae-dong,Gwanak-gu,11562,27789.0,13814.0,13975,26352,13126,13226,1437.0,688.0,749,2.28,3161
Cheongnim-dong,Gwanak-gu,6561,17078.0,8416.0,8662,16766,8265,8501,312.0,151.0,161,2.56,1968
Haengun-dong,Gwanak-gu,15478,30343.0,15013.0,15330,29845,14783,15062,498.0,230.0,268,1.93,3200
Nagseongdae-dong,Gwanak-gu,10090,18301.0,9328.0,8973,17794,9094,8700,507.0,234.0,273,1.76,1631
Jungang-dong,Gwanak-gu,7503,15241.0,7443.0,7798,14750,7220,7530,491.0,223.0,268,1.97,1882
Inheon-dong,Gwanak-gu,13186,28636.0,14295.0,14341,28288,14144,14144,348.0,151.0,197,2.15,2943
Namhyeon-dong,Gwanak-gu,8309,18420.0,8908.0,9512,18177,8790,9387,243.0,118.0,125,2.19,1899
Sewon-dong,Gwanak-gu,12421,24306.0,12357.0,11949,23687,12059,11628,619.0,298.0,321,1.91,2435
Sinwon-dong,Gwanak-gu,9306,20411.0,10109.0,10302,19460,9649,9811,951.0,460.0,491,2.09,2554
Serim-dong,Gwanak-gu,13284,24918.0,13657.0,11261,24568,13497,11071,350.0,160.0,190,1.85,2518
Sinsa-dong,Gwanak-gu,12383,26996.0,13538.0,13458,24917,12484,12433,2079.0,1054.0,1025,2.01,2618
Sillim-dong,Gwanak-gu,13369,22713.0,11393.0,11320,19404,9836,9568,3309.0,1557.0,1752,1.45,1549
Nanhyang-dong,Gwanak-gu,6680,17876.0,8934.0,8942,17788,8887,8901,88.0,47.0,41,2.66,1929
Jowon-dong,Gwanak-gu,9333,20052.0,10256.0,9796,18283,9327,8956,1769.0,929.0,840,1.96,2106
Daehak-dong,Gwanak-gu,14263,24393.0,14470.0,9923,23334,13939,9395,1059.0,531.0,528,1.64,2073
Euncheon-dong,Gwanak-gu,15054,37117.0,18433.0,18684,36284,18064,18220,833.0,369.0,464,2.41,4069
Seonghyeon-dong,Gwanak-gu,12822,34847.0,17136.0,17711,34668,17068,17600,179.0,68.0,111,2.7,4229
Cheongnyong-dong,Gwanak-gu,18166,34628.0,17276.0,17352,33203,16617,16586,1425.0,659.0,766,1.83,3627
Nangok-dong,Gwanak-gu,12792,31103.0,15838.0,15265,30785,15702,15083,318.0,136.0,182,2.41,3830
Samseong-dong,Gwanak-gu,12091,29449.0,14828.0,14621,29321,14771,14550,128.0,57.0,71,2.43,4419
Miseong-dong,Gwanak-gu,13876,34515.0,17376.0,17139,34107,17185,16922,408.0,191.0,217,2.46,3693
Seocho 1(il)-dong,Seocho-gu,9014,21734.0,10487.0,11247,21425,10322,11103,309.0,165.0,144,2.38,2113
Seocho 2(i)-dong,Seocho-gu,8991,23685.0,11730.0,11955,23151,11372,11779,534.0,358.0,176,2.57,2243
Seocho 3(sam)-dong,Seocho-gu,12222,30856.0,15414.0,15442,30491,15236,15255,365.0,178.0,187,2.49,3356
Seocho 4(sa)-dong,Seocho-gu,10552,30775.0,14979.0,15796,30476,14792,15684,299.0,187.0,112,2.89,2799
Jamwon-dong,Seocho-gu,14032,34898.0,16651.0,18247,34609,16509,18100,289.0,142.0,147,2.47,2789
Banpobon-dong,Seocho-gu,4378,13447.0,6368.0,7079,13355,6322,7033,92.0,46.0,46,3.05,1602
Banpo 1(il)-dong,Seocho-gu,14993,34179.0,16492.0,17687,33818,16306,17512,361.0,186.0,175,2.26,2594
Banpo 2(i)-dong,Seocho-gu,6594,20360.0,9647.0,10713,20274,9600,10674,86.0,47.0,39,3.07,1998
Banpo 3(sam)-dong,Seocho-gu,8353,24363.0,11621.0,12742,24315,11600,12715,48.0,21.0,27,2.91,2220
Banpo 4(sa)-dong,Seocho-gu,7356,20859.0,9967.0,10892,20295,9672,10623,564.0,295.0,269,2.76,1894
Bangbaebon-dong,Seocho-gu,8091,22294.0,10583.0,11711,22061,10471,11590,233.0,112.0,121,2.73,2299
Bangbae 1(il)-dong,Seocho-gu,6988,17449.0,8345.0,9104,17293,8283,9010,156.0,62.0,94,2.47,1866
Bangbae 2(i)-dong,Seocho-gu,10817,27418.0,13300.0,14118,27142,13165,13977,276.0,135.0,141,2.51,3032
Bangbae 3(sam)-dong,Seocho-gu,9569,25706.0,12504.0,13202,25560,12434,13126,146.0,70.0,76,2.67,2820
Bangbae 4(sa)-dong,Seocho-gu,9903,25837.0,12049.0,13788,25507,11888,13619,330.0,161.0,169,2.58,2732
Yangjae 1(il)-dong,Seocho-gu,14826,40113.0,19321.0,20792,39694,19116,20578,419.0,205.0,214,2.68,3946
Yangjae 2(i)-dong,Seocho-gu,10459,23289.0,11778.0,11511,22971,11632,11339,318.0,146.0,172,2.2,1948
Naegok-dong,Seocho-gu,2412,5746.0,3048.0,2698,5691,3024,2667,55.0,24.0,31,2.36,1012
Sinsa-dong,Gangnam-gu,8530,20049.0,9383.0,10666,19765,9225,10540,284.0,158.0,126,2.32,2380
Nonhyeon 1(il)-dong,Gangnam-gu,14770,26391.0,12186.0,14205,25834,11900,13934,557.0,286.0,271,1.75,2264
Nonhyeon 2(i)-dong,Gangnam-gu,10791,22775.0,10754.0,12021,22460,10566,11894,315.0,188.0,127,2.08,2308
Samseong 1(il)-dong,Gangnam-gu,5894,16094.0,8173.0,7921,15606,7877,7729,488.0,296.0,192,2.65,1613
Samseong 2(i)-dong,Gangnam-gu,13923,32424.0,15572.0,16852,32234,15457,16777,190.0,115.0,75,2.32,2568
Daechi 1(il)-dong,Gangnam-gu,5984,20382.0,10135.0,10247,20184,10031,10153,198.0,104.0,94,3.37,1401
Daechi 4(sa)-dong,Gangnam-gu,10497,22301.0,10579.0,11722,22011,10417,11594,290.0,162.0,128,2.1,1587
Yeoksam 1(il)-dong,Gangnam-gu,20567,36320.0,17425.0,18895,35111,16727,18384,1209.0,698.0,511,1.71,2857
Yeoksam 2(i)-dong,Gangnam-gu,14027,34815.0,16476.0,18339,34492,16289,18203,323.0,187.0,136,2.46,2671
Dogok 1(il)-dong,Gangnam-gu,8464,22873.0,10978.0,11895,22663,10868,11795,210.0,110.0,100,2.68,1991
Dogok 2(i)-dong,Gangnam-gu,12118,35391.0,16734.0,18657,35177,16605,18572,214.0,129.0,85,2.9,3134
Gaepo 1(il)-dong,Gangnam-gu,8912,23151.0,11042.0,12109,22995,10973,12022,156.0,69.0,87,2.58,2335
Gaepo 4(sa)-dong,Gangnam-gu,9687,23690.0,11598.0,12092,23578,11547,12031,112.0,51.0,61,2.43,1900
Irwonbon-dong,Gangnam-gu,7595,23135.0,11254.0,11881,23084,11236,11848,51.0,18.0,33,3.04,1572
Irwon 1(il)-dong,Gangnam-gu,7659,18648.0,9058.0,9590,18504,8993,9511,144.0,65.0,79,2.42,2198
Irwon 2(i)-dong,Gangnam-gu,7267,18985.0,9355.0,9630,18950,9335,9615,35.0,20.0,15,2.61,1809
Suseo-dong,Gangnam-gu,7483,16700.0,7587.0,9113,16556,7534,9022,144.0,53.0,91,2.21,2729
Segok-dong,Gangnam-gu,5191,15216.0,7478.0,7738,15131,7432,7699,85.0,46.0,39,2.91,2075
Apgujeong -dong,Gangnam-gu,11140,29327.0,13655.0,15672,29138,13564,15574,189.0,91.0,98,2.62,3805
Cheongdam -dong,Gangnam-gu,12657,31568.0,15067.0,16501,31260,14913,16347,308.0,154.0,154,2.47,3143
Daechi 2(i)-dong,Gangnam-gu,13864,42682.0,21589.0,21093,42423,21451,20972,259.0,138.0,121,3.06,3174
Gaepo 2(i)-dong,Gangnam-gu,12768,34718.0,16716.0,18002,34626,16678,17948,92.0,38.0,54,2.71,2427
Pungnap 1(il)-dong,Songpa-gu,7822,19751.0,9759.0,9992,18820,9308,9512,931.0,451.0,480,2.41,2203
Pungnap 2(i)-dong,Songpa-gu,10889,28495.0,13740.0,14755,28337,13682,14655,158.0,58.0,100,2.6,2522
Geoyeo 1(il)-dong,Songpa-gu,5878,15937.0,8119.0,7818,15744,8048,7696,193.0,71.0,122,2.68,1521
Geoyeo 2(i)-dong,Songpa-gu,10955,28110.0,14252.0,13858,27969,14199,13770,141.0,53.0,88,2.55,2982
Macheon 1(il)-dong,Songpa-gu,9451,24171.0,12153.0,12018,23902,12067,11835,269.0,86.0,183,2.53,2868
Macheon 2(i)-dong,Songpa-gu,8645,22295.0,11362.0,10933,22072,11276,10796,223.0,86.0,137,2.55,2680
Bangi 1(il)-dong,Songpa-gu,6150,17135.0,8469.0,8666,16896,8342,8554,239.0,127.0,112,2.75,1426
Bangi 2(i)-dong,Songpa-gu,11620,26090.0,12873.0,13217,25706,12709,12997,384.0,164.0,220,2.21,2248
Oryun-dong,Songpa-gu,6078,20225.0,9918.0,10307,20197,9902,10295,28.0,16.0,12,3.32,1532
Ogeum-dong,Songpa-gu,14159,38555.0,19131.0,19424,38364,19047,19317,191.0,84.0,107,2.71,3627
Songpa 1(il)-dong,Songpa-gu,11840,27757.0,13194.0,14563,27241,12929,14312,516.0,265.0,251,2.3,2365
Songpa 2(i)-dong,Songpa-gu,7722,22926.0,11132.0,11794,22754,11046,11708,172.0,86.0,86,2.95,1853
Seokchon-dong,Songpa-gu,15724,36018.0,17495.0,18523,35256,17138,18118,762.0,357.0,405,2.24,3113
Samjeon-dong,Songpa-gu,15859,35310.0,16913.0,18397,34932,16747,18185,378.0,166.0,212,2.2,2629
Garakbon-dong,Songpa-gu,11556,29809.0,14952.0,14857,29408,14752,14656,401.0,200.0,201,2.54,2360
Garak 1(il)-dong,Songpa-gu,1223,2782.0,1423.0,1359,2699,1374,1325,83.0,49.0,34,2.21,350
Garak 2(i)-dong,Songpa-gu,12405,35946.0,17671.0,18275,35754,17578,18176,192.0,93.0,99,2.88,2537
Munjeong 1(il)-dong,Songpa-gu,8415,22764.0,11166.0,11598,22549,11068,11481,215.0,98.0,117,2.68,1896
Munjeong 2(i)-dong,Songpa-gu,5786,16493.0,8051.0,8442,16431,8014,8417,62.0,37.0,25,2.84,2189
Jangji-dong,Songpa-gu,13699,37695.0,18529.0,19166,37558,18477,19081,137.0,52.0,85,2.74,3043
Jamsilbon-dong,Songpa-gu,14335,31505.0,15095.0,16410,30761,14715,16046,744.0,380.0,364,2.15,2538
Jamsil 4(sa)-dong,Songpa-gu,10962,31435.0,15273.0,16162,31342,15223,16119,93.0,50.0,43,2.86,2661
Jamsil 6(yuk)-dong,Songpa-gu,5795,17487.0,8419.0,9068,17444,8392,9052,43.0,27.0,16,3.01,1756
Jamsil 7(chil)-dong,Songpa-gu,3495,10688.0,5014.0,5674,10671,5004,5667,17.0,10.0,7,3.05,1458
Jamsil 2(i)-dong,Songpa-gu,12594,37200.0,17829.0,19371,37070,17757,19313,130.0,72.0,58,2.94,2282
Jamsil 3(sam)-dong,Songpa-gu,12623,37436.0,18019.0,19417,37306,17937,19369,130.0,82.0,48,2.96,3482
Gangil-dong,Gangdong-gu,10812,34468.0,16839.0,17629,34214,16703,17511,254.0,136.0,118,3.16,3335
Sangil-dong,Gangdong-gu,9608,27630.0,13825.0,13805,27442,13748,13694,188.0,77.0,111,2.86,2311
Myeongil 1(il)-dong,Gangdong-gu,10032,28450.0,13952.0,14498,28337,13912,14425,113.0,40.0,73,2.82,2443
Myeongil 2(i)-dong,Gangdong-gu,6021,18929.0,9491.0,9438,18902,9476,9426,27.0,15.0,12,3.14,1455
Godeok 1(il)-dong,Gangdong-gu,5792,17392.0,8822.0,8570,17272,8770,8502,120.0,52.0,68,2.98,1461
Godeok 2(i)-dong,Gangdong-gu,6925,17970.0,9238.0,8732,17871,9197,8674,99.0,41.0,58,2.58,1814
Amsa 2(i)-dong,Gangdong-gu,6249,16473.0,8136.0,8337,16424,8111,8313,49.0,25.0,24,2.63,1380
Amsa 3(sam)-dong,Gangdong-gu,6228,19293.0,9520.0,9773,19274,9507,9767,19.0,13.0,6,3.09,1474
Cheonho 1(il)-dong,Gangdong-gu,13035,31743.0,15919.0,15824,31183,15693,15490,560.0,226.0,334,2.39,3426
Cheonho 3(sam)-dong,Gangdong-gu,12297,26724.0,13510.0,13214,26269,13303,12966,455.0,207.0,248,2.14,3134
Seongnae 1(il)-dong,Gangdong-gu,7378,19946.0,9822.0,10124,19683,9706,9977,263.0,116.0,147,2.67,1808
Seongnae 2(i)-dong,Gangdong-gu,12055,27007.0,13450.0,13557,26411,13174,13237,596.0,276.0,320,2.19,2927
Seongnae 3(sam)-dong,Gangdong-gu,10367,25626.0,12806.0,12820,25395,12704,12691,231.0,102.0,129,2.45,2401
Dunchon 1(il)-dong,Gangdong-gu,6426,20087.0,10301.0,9786,20018,10270,9748,69.0,31.0,38,3.12,1345
Dunchon 2(i)-dong,Gangdong-gu,10711,29689.0,14799.0,14890,29561,14741,14820,128.0,58.0,70,2.76,2722
Amsa 1(il)-dong,Gangdong-gu,15826,39206.0,19529.0,19677,38771,19368,19403,435.0,161.0,274,2.45,3920
Cheonho 2(i)-dong,Gangdong-gu,17035,38307.0,19421.0,18886,37527,19046,18481,780.0,375.0,405,2.2,4248
Gil-dong,Gangdong-gu,19943,51400.0,25538.0,25862,51017,25395,25622,383.0,143.0,240,2.56,4855
