Dong,복지_장애인현황연령별_Autonomous Gu_Autonomous Gu_Autonomous Gu,복지_장애인현황연령별_By age_total_total,복지_장애인현황연령별_By age_total_Male,복지_장애인현황연령별_By age_total_Female,복지_장애인현황연령별_By age_ _total,복지_장애인현황연령별_By age_ _Male,복지_장애인현황연령별_By age_ _Female,복지_장애인현황연령별_By age_ 10~19 Years old_total,복지_장애인현황연령별_By age_ 10~19 Years old_Male,복지_장애인현황연령별_By age_ 10~19 Years old_Female,복지_장애인현황연령별_By age_ 20~29 Years old_total,복지_장애인현황연령별_By age_ 20~29 Years old_Male,복지_장애인현황연령별_By age_ 20~29 Years old_Female,복지_장애인현황연령별_By age_ 30~39 Years old_total,복지_장애인현황연령별_By age_ 30~39 Years old_Male,복지_장애인현황연령별_By age_ 30~39 Years old_Female,복지_장애인현황연령별_By age_ 40~49 Years old_total,복지_장애인현황연령별_By age_ 40~49 Years old_Male,복지_장애인현황연령별_By age_ 40~49 Years old_Female,복지_장애인현황연령별_By age_ 50~59 Years old_total,복지_장애인현황연령별_By age_ 50~59 Years old_Male,복지_장애인현황연령별_By age_ 50~59 Years old_Female,복지_장애인현황연령별_By age_ 60~69 Years old_total,복지_장애인현황연령별_By age_ 60~69 Years old_Male,복지_장애인현황연령별_By age_ 60~69 Years old_Female,복지_장애인현황연령별_By age_ 70~79 Years old_total,복지_장애인현황연령별_By age_ 70~79 Years old_Male,복지_장애인현황연령별_By age_ 70~79 Years old_Female,복지_장애인현황연령별_By age_ 80 Years old and over_total,복지_장애인현황연령별_By age_ 80 Years old and over_Male,복지_장애인현황연령별_By age_ 80 Years old and over_Female
Sajik-dong,Jongno-gu,347.0,200,147,9,6,3,18,11,7,17,13,4,17,12,5,37,25,12,60,40,20,55,37,18,97,42,55,37,14,23
Samcheong-dong,Jongno-gu,135.0,77,58,-,-,-,7,5,2,2,2,-,12,7,5,19,14,5,23,13,10,24,15,9,28,12,16,20,9,11
Buam-dong,Jongno-gu,370.0,208,162,6,4,2,8,5,3,20,15,5,17,12,5,51,32,19,47,29,18,73,45,28,96,43,53,52,23,29
Pyeongchang-dong,Jongno-gu,608.0,315,293,2,2,-,11,7,4,29,17,12,32,21,11,78,55,23,117,70,47,100,53,47,149,68,81,90,22,68
Muak-dong,Jongno-gu,337.0,203,134,5,3,2,14,10,4,13,7,6,16,9,7,33,23,10,68,47,21,62,38,24,93,52,41,33,14,19
Gyonam-dong,Jongno-gu,252.0,138,114,-,-,-,3,2,1,9,6,3,16,12,4,35,22,13,50,38,12,68,30,38,55,22,33,16,6,10
Gahoe-dong,Jongno-gu,197.0,111,86,-,-,-,12,8,4,8,6,2,9,7,2,22,18,4,29,17,12,42,24,18,52,20,32,23,11,12
Jongno 1·2·3·4(ilisamsa)-ga-dong,Jongno-gu,424.0,287,137,-,-,-,6,4,2,10,6,4,32,28,4,49,44,5,105,88,17,100,61,39,90,42,48,32,14,18
Jongno 5·6(oryuk)-ga-dong,Jongno-gu,309.0,195,114,-,-,-,7,3,4,15,10,5,24,18,6,35,28,7,60,44,16,78,49,29,59,31,28,31,12,19
Ihwa-dong,Jongno-gu,331.0,168,163,2,1,1,12,9,3,10,5,5,24,12,12,45,29,16,71,46,25,58,28,30,77,29,48,32,9,23
Changsin 1(il)-dong,Jongno-gu,331.0,208,123,1,1,-,5,3,2,5,2,3,11,8,3,44,33,11,80,62,18,98,59,39,59,27,32,28,13,15
Changsin 2(i)-dong,Jongno-gu,566.0,320,246,4,2,2,12,7,5,16,12,4,31,24,7,83,61,22,124,86,38,128,70,58,131,53,78,37,5,32
Changsin 3(sam)-dong,Jongno-gu,373.0,221,152,4,2,2,11,7,4,8,6,2,26,21,5,55,41,14,74,53,21,75,44,31,84,35,49,36,12,24
Sungin 1(il)-dong,Jongno-gu,319.0,180,139,2,2,-,6,2,4,8,3,5,15,12,3,43,31,12,78,51,27,74,37,37,71,34,37,22,8,14
Sungin 2(i)-dong,Jongno-gu,509.0,318,191,3,2,1,6,4,2,16,13,3,26,20,6,52,38,14,118,82,36,128,81,47,122,62,60,38,16,22
Cheongunhyoja-dong,Jongno-gu,612.0,337,275,13,8,5,56,34,22,44,28,16,35,20,15,74,50,24,105,72,33,106,52,54,125,55,70,54,18,36
Hyehwa-dong,Jongno-gu,621.0,361,260,6,5,1,16,12,4,23,15,8,42,28,14,74,57,17,111,79,32,123,64,59,173,79,94,53,22,31
Sogong-dong,Jung-gu,42.0,23,19,1,-,1,1,1,-,4,3,1,5,5,-,4,1,3,8,6,2,7,5,2,8,2,6,4,-,4
Hoehyeon-dong,Jung-gu,381.0,245,136,1,-,1,4,3,1,9,7,2,15,9,6,47,36,11,111,94,17,102,50,52,65,36,29,27,10,17
Myeong-dong,Jung-gu,142.0,82,60,-,-,-,-,-,-,5,3,2,10,7,3,24,17,7,31,19,12,31,15,16,32,18,14,9,3,6
Pil-dong,Jung-gu,188.0,111,77,-,-,-,1,1,-,7,1,6,12,9,3,29,21,8,45,29,16,30,25,5,41,21,20,23,4,19
Jangchung-dong,Jung-gu,231.0,125,106,-,-,-,3,1,2,10,7,3,10,7,3,25,16,9,42,27,15,53,26,27,68,33,35,20,8,12
Gwanghui-dong ,Jung-gu,264.0,159,105,2,2,-,1,1,-,5,5,-,17,14,3,23,17,6,55,35,20,82,57,25,62,22,40,17,6,11
Euljiro-dong,Jung-gu,111.0,78,33,2,-,2,-,-,-,4,3,1,3,3,-,11,10,1,35,26,9,27,21,6,14,8,6,15,7,8
Sindang 5(o)-dong,Jung-gu,508.0,317,191,3,3,-,13,9,4,14,12,2,36,30,6,69,52,17,119,84,35,97,55,42,114,46,68,43,26,17
Hwanghak-dong,Jung-gu,581.0,337,244,7,6,1,14,10,4,14,9,5,55,42,13,73,57,16,109,75,34,148,80,68,114,39,75,47,19,28
Jungnim-dong,Jung-gu,481.0,278,203,3,1,2,10,5,5,16,9,7,40,29,11,48,38,10,108,70,38,105,60,45,106,49,57,45,17,28
Sindang-dong,Jung-gu,422.0,258,164,1,1,-,11,9,2,7,5,2,30,20,10,62,45,17,95,68,27,98,54,44,95,48,47,23,8,15
Dasan-dong,Jung-gu,728.0,405,323,4,2,2,22,13,9,27,18,9,40,28,12,88,57,31,144,84,60,168,89,79,170,90,80,65,24,41
Yaksu-dong,Jung-gu,904.0,487,417,6,5,1,10,7,3,28,14,14,56,36,20,96,65,31,181,121,60,206,108,98,223,99,124,98,32,66
Cheonggu-dong,Jung-gu,665.0,364,301,6,4,2,11,5,6,28,18,10,38,28,10,80,49,31,157,102,55,141,80,61,145,58,87,59,20,39
Donghwa-dong,Jung-gu,454.0,244,210,2,1,1,14,9,5,18,7,11,24,16,8,45,29,16,101,58,43,76,48,28,114,55,59,60,21,39
Huam-dong,Yongsan-gu,907.0,537,370,12,8,4,42,33,9,48,33,15,66,52,14,110,70,40,164,108,56,214,122,92,179,79,100,72,32,40
Yongsan 2-ga-dong,Yongsan-gu,569.0,316,253,3,2,1,13,10,3,14,7,7,42,29,13,65,44,21,114,65,49,128,77,51,129,52,77,61,30,31
Namyeong-dong,Yongsan-gu,561.0,414,147,2,2,-,6,4,2,9,6,3,36,29,7,88,79,9,159,132,27,120,85,35,102,61,41,39,16,23
Wonhyoro 2(i)-dong,Yongsan-gu,548.0,301,247,6,5,1,15,9,6,19,11,8,28,17,11,77,52,25,114,75,39,114,65,49,113,48,65,62,19,43
Hyochang-dong,Yongsan-gu,408.0,228,180,4,2,2,10,7,3,13,8,5,20,18,2,38,28,10,84,62,22,99,44,55,101,44,57,39,15,24
Yongmun-dong,Yongsan-gu,456.0,241,215,5,1,4,12,7,5,20,13,7,38,20,18,48,35,13,81,54,27,114,57,57,105,46,59,33,8,25
Ichon 1(il)-dong,Yongsan-gu,529.0,296,233,7,5,2,19,16,3,19,15,4,32,24,8,54,35,19,79,51,28,92,52,40,131,60,71,96,38,58
Ichon 2(i)-dong,Yongsan-gu,398.0,220,178,5,3,2,8,6,2,13,8,5,28,20,8,41,30,11,72,41,31,82,45,37,94,43,51,55,24,31
Itaewon 1(il)-dong,Yongsan-gu,284.0,163,121,4,3,1,4,1,3,4,4,-,25,19,6,39,23,16,50,37,13,54,30,24,66,37,29,38,9,29
Itaewon 2(i)-dong,Yongsan-gu,417.0,232,185,7,4,3,9,4,5,9,8,1,29,20,9,46,37,9,72,49,23,83,45,38,116,51,65,46,14,32
Seobinggo-dong,Yongsan-gu,394.0,214,180,3,2,1,18,12,6,12,11,1,13,9,4,67,41,26,63,37,26,73,36,37,103,44,59,42,22,20
Bogwang-dong,Yongsan-gu,688.0,383,305,1,1,-,5,5,-,16,10,6,54,36,18,95,68,27,135,83,52,153,84,69,176,73,103,53,23,30
Cheongpa-dong,Yongsan-gu,908.0,525,383,7,4,3,24,17,7,30,20,10,83,56,27,137,104,33,184,124,60,181,90,91,202,90,112,60,20,40
Wonhyoro 1(il)-dong,Yongsan-gu,446.0,243,203,5,5,-,9,7,2,18,11,7,32,23,9,42,31,11,84,51,33,102,50,52,114,51,63,40,14,26
Hangangno-dong,Yongsan-gu,615.0,391,224,3,2,1,9,6,3,15,10,5,53,39,14,61,48,13,105,80,25,155,100,55,146,82,64,68,24,44
Hannam-dong,Yongsan-gu,741.0,401,340,3,1,2,9,6,3,27,17,10,58,38,20,87,68,19,135,82,53,169,86,83,194,81,113,59,22,37
Wangsimni 2(i)-dong,Seongdong-gu,690.0,382,308,9,6,3,22,13,9,22,14,8,48,28,20,78,55,23,148,97,51,173,92,81,149,63,86,41,14,27
Majang-dong,Seongdong-gu,1183.0,718,465,15,11,4,51,34,17,25,19,6,76,60,16,135,89,46,275,197,78,246,154,92,268,114,154,92,40,52
Sageun-dong,Seongdong-gu,441.0,247,194,1,1,-,7,4,3,10,7,3,19,13,6,48,32,16,72,53,19,105,53,52,141,68,73,38,16,22
Haengdang 1(il)-dong,Seongdong-gu,726.0,429,297,3,3,-,8,5,3,26,21,5,45,27,18,86,53,33,159,116,43,163,94,69,174,89,85,62,21,41
Haengdang 2(i)-dong,Seongdong-gu,922.0,522,400,8,6,2,24,11,13,30,19,11,61,46,15,113,76,37,192,116,76,194,115,79,229,105,124,71,28,43
Eungbong-dong,Seongdong-gu,560.0,307,253,2,2,-,22,11,11,16,15,1,26,16,10,73,50,23,96,61,35,106,63,43,156,70,86,63,19,44
Geumho 1(il)-ga-dong,Seongdong-gu,695.0,379,316,2,1,1,11,5,6,16,10,6,42,31,11,84,55,29,142,94,48,167,100,67,168,65,103,63,18,45
Geumho 4(sa)-ga-dong,Seongdong-gu,560.0,315,245,4,3,1,12,8,4,22,15,7,27,18,9,74,56,18,116,72,44,125,69,56,127,57,70,53,17,36
Seongsu 1(il)-ga1(il)-dong,Seongdong-gu,673.0,415,258,4,3,1,21,12,9,27,19,8,45,33,12,98,74,24,144,110,34,149,82,67,129,62,67,56,20,36
Seongsu 1(il)-ga2(i)-dong,Seongdong-gu,668.0,369,299,3,-,3,17,10,7,24,16,8,51,31,20,76,53,23,136,90,46,146,89,57,163,64,99,52,16,36
Seongsu 2(i)-ga1(il)-dong,Seongdong-gu,878.0,560,318,8,5,3,34,26,8,33,28,5,49,39,10,109,81,28,222,164,58,191,110,81,171,84,87,61,23,38
Seongsu 2(i)-ga 3(sam)-dong,Seongdong-gu,463.0,282,181,3,1,2,8,3,5,21,11,10,34,29,5,50,32,18,110,80,30,99,58,41,109,57,52,29,11,18
Songjeong-dong,Seongdong-gu,541.0,328,213,-,-,-,12,10,2,14,8,6,33,25,8,87,64,23,141,93,48,115,70,45,109,51,58,30,7,23
Yongdap-dong,Seongdong-gu,825.0,505,320,4,3,1,18,10,8,23,13,10,63,47,16,136,103,33,201,151,50,199,99,100,144,68,76,37,11,26
WangsimniDoseon-dong,Seongdong-gu,627.0,354,273,5,3,2,13,6,7,17,10,7,36,28,8,81,50,31,114,70,44,130,86,44,170,76,94,61,25,36
Geumho 2.3(i.sam)-ga-dong,Seongdong-gu,915.0,522,393,4,4,-,17,11,6,24,17,7,65,39,26,105,72,33,188,133,55,201,114,87,224,106,118,87,26,61
Oksu-dong,Seongdong-gu,685.0,390,295,14,10,4,20,15,5,28,19,9,47,39,8,86,56,30,110,70,40,143,83,60,166,73,93,71,25,46
Hwayang-dong,Gwangjin-gu,662.0,387,275,3,2,1,13,10,3,33,22,11,61,45,16,95,75,20,121,78,43,134,73,61,150,64,86,52,18,34
Gunja-dong,Gwangjin-gu,830.0,477,353,2,2,-,21,13,8,45,31,14,56,40,16,105,66,39,190,120,70,182,104,78,170,85,85,59,16,43
Junggok 1(il)-dong,Gwangjin-gu,705.0,418,287,4,2,2,10,7,3,30,20,10,53,34,19,85,57,28,185,116,69,158,88,70,130,73,57,50,21,29
Junggok 2(i)-dong,Gwangjin-gu,887.0,512,375,7,4,3,24,12,12,41,26,15,66,46,20,117,80,37,212,141,71,204,111,93,166,74,92,50,18,32
Junggok 3(sam)-dong,Gwangjin-gu,804.0,516,288,6,4,2,18,12,6,21,16,5,72,49,23,131,99,32,191,129,62,174,102,72,144,86,58,47,19,28
Junggok 4(sa)-dong,Gwangjin-gu,1296.0,749,547,11,7,4,25,18,7,56,38,18,82,61,21,184,125,59,292,181,111,310,177,133,246,116,130,90,26,64
Neung-dong,Gwangjin-gu,392.0,226,166,2,-,2,8,4,4,22,12,10,46,29,17,43,26,17,62,39,23,92,59,33,89,49,40,28,8,20
Guui 1(il)-dong,Gwangjin-gu,809.0,467,342,5,4,1,20,10,10,34,23,11,68,45,23,126,83,43,171,102,69,159,100,59,172,82,90,54,18,36
Guui 2(i)-dong,Gwangjin-gu,1170.0,699,471,10,6,4,27,17,10,37,28,9,100,70,30,164,111,53,282,181,101,235,142,93,210,108,102,105,36,69
Guui 3(sam)-dong,Gwangjin-gu,811.0,461,350,5,1,4,27,17,10,42,31,11,74,49,25,88,66,22,163,112,51,159,80,79,183,81,102,70,24,46
Gwangjang-dong,Gwangjin-gu,755.0,458,297,17,12,5,38,29,9,41,33,8,48,33,15,111,81,30,136,92,44,129,67,62,158,82,76,77,29,48
Jayang 1(il)-dong,Gwangjin-gu,921.0,521,400,3,2,1,23,16,7,26,13,13,43,31,12,119,74,45,202,128,74,233,132,101,202,97,105,70,28,42
Jayang 2(i)-dong,Gwangjin-gu,1022.0,598,424,7,4,3,38,26,12,39,25,14,85,57,28,144,88,56,232,149,83,229,133,96,188,93,95,60,23,37
Jayang 3(sam)-dong,Gwangjin-gu,842.0,468,374,10,6,4,29,17,12,40,23,17,60,35,25,108,72,36,169,117,52,159,89,70,174,80,94,93,29,64
Jayang 4(sa)-dong,Gwangjin-gu,1105.0,670,435,3,-,3,27,18,9,29,14,15,79,65,14,132,95,37,272,196,76,263,147,116,230,115,115,70,20,50
Hoegi-dong,Dongdaemun-gu,368.0,209,159,4,2,2,9,6,3,19,13,6,18,15,3,35,24,11,65,43,22,86,45,41,92,43,49,40,18,22
Hwigyeong 1(il)-dong,Dongdaemun-gu,725.0,408,317,3,1,2,11,7,4,28,20,8,48,29,19,95,62,33,152,101,51,168,91,77,165,82,83,55,15,40
Hwigyeong 2(i)-dong,Dongdaemun-gu,849.0,481,368,6,5,1,18,12,6,40,27,13,50,32,18,94,68,26,170,113,57,209,110,99,198,92,106,64,22,42
Cheongnyangni-dong,Dongdaemun-gu,1419.0,834,585,7,6,1,24,16,8,38,28,10,72,54,18,135,103,32,318,221,97,356,191,165,347,165,182,122,50,72
Yongsin-dong,Dongdaemun-gu,1550.0,913,637,9,5,4,20,10,10,37,24,13,91,70,21,189,137,52,346,243,103,372,193,179,367,187,180,119,44,75
Jegi-dong,Dongdaemun-gu,1381.0,798,583,8,6,2,27,18,9,44,29,15,89,69,20,149,100,49,281,198,83,333,176,157,330,158,172,120,44,76
Jeonnong 1(il)-dong,Dongdaemun-gu,1738.0,1030,708,12,7,5,33,25,8,43,33,10,91,61,30,244,181,63,403,269,134,404,220,184,393,187,206,115,47,68
Jeonnong 2(i)-dong,Dongdaemun-gu,909.0,526,383,8,6,2,18,12,6,27,22,5,60,45,15,100,77,23,205,128,77,204,112,92,213,95,118,74,29,45
Dapsimni 1(il)-dong,Dongdaemun-gu,922.0,523,399,8,3,5,14,11,3,23,14,9,60,37,23,99,77,22,213,138,75,195,109,86,240,110,130,70,24,46
Dapsimni 2(i)-dong,Dongdaemun-gu,1530.0,902,628,13,11,2,32,21,11,46,32,14,87,60,27,228,146,82,369,254,115,304,169,135,350,173,177,101,36,65
Jangan 1(il)-dong,Dongdaemun-gu,1527.0,926,601,13,8,5,37,27,10,59,40,19,129,87,42,184,135,49,372,236,136,358,215,143,297,155,142,78,23,55
Jangan 2(i)-dong,Dongdaemun-gu,1278.0,786,492,9,9,-,37,24,13,38,30,8,103,74,29,170,128,42,257,185,72,310,169,141,265,129,136,89,38,51
Imun 1(il)-dong,Dongdaemun-gu,1329.0,790,539,4,4,-,18,16,2,46,30,16,107,78,29,169,119,50,284,193,91,293,168,125,315,150,165,93,32,61
Imun 2(i)-dong,Dongdaemun-gu,972.0,536,436,8,5,3,19,14,5,23,15,8,57,41,16,129,89,40,206,127,79,240,114,126,227,109,118,63,22,41
Myeonmok 2(i)-dong,Jungnang-gu,1312.0,757,555,9,8,1,28,23,5,38,24,14,98,84,14,177,122,55,285,181,104,326,168,158,271,119,152,80,28,52
Myeonmok 4(sa)-dong,Jungnang-gu,1351.0,830,521,5,5,-,27,17,10,47,32,15,94,70,24,199,139,60,339,235,104,369,200,169,207,111,96,64,21,43
Myeonmok 5(o)-dong,Jungnang-gu,701.0,444,257,6,6,-,14,7,7,16,11,5,40,24,16,91,69,22,171,124,47,158,96,62,158,97,61,47,10,37
Myeonmok 7(chil)-dong,Jungnang-gu,1070.0,638,432,8,5,3,22,15,7,44,35,9,74,53,21,151,107,44,231,156,75,238,136,102,230,103,127,72,28,44
Sangbong 1(il)-dong,Jungnang-gu,1421.0,837,584,9,4,5,49,30,19,59,41,18,92,72,20,202,130,72,374,253,121,300,167,133,256,114,142,80,26,54
Sangbong 2(i)-dong,Jungnang-gu,916.0,539,377,5,4,1,13,9,4,30,18,12,64,50,14,113,81,32,220,130,90,243,144,99,171,88,83,57,15,42
Junghwa 1(il)-dong,Jungnang-gu,889.0,523,366,8,7,1,31,22,9,33,22,11,58,41,17,96,67,29,210,136,74,221,123,98,178,86,92,54,19,35
Junghwa 2(i)-dong,Jungnang-gu,1634.0,935,699,5,3,2,40,18,22,50,33,17,121,84,37,220,156,64,438,272,166,345,194,151,318,137,181,97,38,59
Muk 1(il)-dong,Jungnang-gu,1444.0,841,603,13,7,6,31,20,11,58,35,23,112,84,28,177,126,51,299,189,110,348,193,155,306,153,153,100,34,66
Muk 2(i)-dong,Jungnang-gu,907.0,532,375,2,1,1,23,14,9,40,31,9,63,45,18,130,90,40,193,114,79,235,137,98,169,80,89,52,20,32
Mangu 3(sam)-dong,Jungnang-gu,944.0,581,363,5,4,1,31,22,9,25,16,9,60,41,19,145,112,33,241,154,87,208,130,78,163,73,90,66,29,37
Sinnae 1(il)-dong,Jungnang-gu,1441.0,805,636,24,20,4,36,21,15,49,31,18,98,67,31,178,138,40,323,199,124,288,151,137,334,148,186,111,30,81
Sinnae 2(i)-dong,Jungnang-gu,1446.0,827,619,6,3,3,38,28,10,54,37,17,82,63,19,179,97,82,422,268,154,339,187,152,228,106,122,98,38,60
Myeonmokbon-dong,Jungnang-gu,1794.0,1058,736,9,5,4,39,26,13,57,42,15,139,99,40,265,189,76,410,255,155,391,208,183,388,195,193,96,39,57
Myeonmok 3.8(sam.pal)-dong,Jungnang-gu,1297.0,754,543,8,3,5,26,21,5,48,34,14,87,57,30,171,115,56,307,204,103,303,177,126,274,121,153,73,22,51
Mangubon-dong,Jungnang-gu,1772.0,1047,725,13,9,4,40,25,15,61,49,12,104,70,34,248,189,59,396,264,132,382,225,157,382,173,209,146,43,103
Donam 1(il)-dong,Seongbuk-gu,611.0,347,264,3,1,2,11,7,4,20,16,4,37,25,12,60,44,16,123,78,45,131,73,58,157,76,81,69,27,42
Donam 2(i)-dong,Seongbuk-gu,653.0,385,268,5,3,2,21,16,5,29,17,12,29,21,8,82,50,32,118,80,38,140,84,56,147,82,65,82,32,50
Anam-dong,Seongbuk-gu,670.0,387,283,12,6,6,79,48,31,26,19,7,42,31,11,89,65,24,122,71,51,110,64,46,134,64,70,56,19,37
Bomun-dong,Seongbuk-gu,605.0,333,272,2,1,1,8,7,1,22,14,8,40,24,16,76,52,24,127,88,39,124,63,61,152,65,87,54,19,35
Jeongneung 1(il)-dong,Seongbuk-gu,743.0,408,335,6,5,1,25,18,7,24,22,2,46,32,14,77,57,20,135,87,48,175,84,91,190,79,111,65,24,41
Jeongneung 2(i)-dong,Seongbuk-gu,941.0,525,416,8,6,2,23,16,7,33,25,8,65,48,17,107,74,33,190,113,77,219,125,94,218,89,129,78,29,49
Jeongneung 3(sam)-dong,Seongbuk-gu,826.0,472,354,5,5,-,17,13,4,18,12,6,45,32,13,96,72,24,161,105,56,193,115,78,214,90,124,77,28,49
Jeongneung 4(sa)-dong,Seongbuk-gu,1048.0,604,444,11,7,4,20,9,11,30,19,11,76,55,21,147,111,36,212,139,73,235,121,114,225,105,120,92,38,54
Gireum 1(il)-dong,Seongbuk-gu,1108.0,605,503,20,13,7,25,13,12,32,21,11,90,61,29,179,125,54,178,114,64,235,115,120,249,108,141,100,35,65
Gireum 2(i)-dong,Seongbuk-gu,987.0,568,419,6,5,1,21,14,7,35,22,13,62,43,19,111,77,34,225,158,67,228,127,101,219,96,123,80,26,54
Wolgok 1(il)-dong,Seongbuk-gu,1296.0,725,571,12,6,6,25,16,9,45,29,16,106,66,40,171,117,54,263,174,89,308,164,144,290,133,157,76,20,56
Wolgok 2(i)-dong,Seongbuk-gu,981.0,574,407,9,7,2,21,12,9,29,15,14,68,47,21,117,84,33,206,151,55,210,118,92,231,112,119,90,28,62
Jangwi 1(il)-dong,Seongbuk-gu,1153.0,663,490,8,5,3,25,15,10,27,13,14,72,53,19,167,115,52,250,147,103,270,155,115,263,134,129,71,26,45
Jangwi 2(i)-dong,Seongbuk-gu,1033.0,628,405,8,6,2,25,17,8,30,23,7,69,50,19,143,112,31,233,152,81,232,133,99,219,110,109,74,25,49
Jangwi 3(sam)-dong,Seongbuk-gu,950.0,577,373,5,3,2,17,12,5,32,25,7,67,46,21,121,81,40,210,145,65,220,137,83,230,109,121,48,19,29
Seongbuk-dong,Seongbuk-gu,653.0,378,275,5,3,2,29,22,7,24,15,9,54,36,18,72,52,20,114,76,38,121,65,56,157,71,86,77,38,39
Samseon-dong,Seongbuk-gu,1084.0,615,469,10,5,5,22,16,6,42,26,16,80,59,21,139,95,44,189,129,60,239,132,107,280,123,157,83,30,53
Dongseon-dong,Seongbuk-gu,622.0,357,265,7,5,2,14,4,10,25,19,6,39,30,9,67,48,19,108,73,35,164,86,78,148,72,76,50,20,30
Jongam-dong,Seongbuk-gu,1634.0,932,702,14,9,5,45,28,17,48,31,17,117,86,31,211,151,60,331,216,115,316,180,136,388,163,225,164,68,96
Seokgwan-dong,Seongbuk-gu,1769.0,1060,709,15,7,8,34,24,10,63,39,24,119,91,28,221,158,63,396,269,127,449,254,195,365,186,179,107,32,75
Beon 1(il)-dong,Gangbuk-gu,917.0,546,371,9,5,4,18,14,4,23,15,8,78,51,27,113,87,26,210,139,71,203,107,96,208,102,106,55,26,29
Beon 2(i)-dong,Gangbuk-gu,1358.0,790,568,8,3,5,32,19,13,45,24,21,84,65,19,175,120,55,276,190,86,373,197,176,291,144,147,74,28,46
Beon 3(sam)-dong,Gangbuk-gu,2029.0,1153,876,11,5,6,55,39,16,56,35,21,124,82,42,282,189,93,436,277,159,540,266,274,445,234,211,80,26,54
Suyu 1(il)-dong,Gangbuk-gu,1200.0,680,520,38,21,17,62,34,28,65,38,27,80,61,19,151,112,39,228,142,86,273,144,129,224,97,127,79,31,48
Suyu 2(i)-dong,Gangbuk-gu,1028.0,582,446,8,5,3,35,21,14,39,26,13,60,38,22,120,85,35,181,108,73,259,138,121,249,130,119,77,31,46
Suyu 3(sam)-dong,Gangbuk-gu,1145.0,674,471,7,5,2,25,20,5,44,30,14,91,67,24,145,93,52,243,160,83,258,141,117,251,131,120,81,27,54
Samyang-dong,Gangbuk-gu,1623.0,929,694,18,10,8,42,22,20,59,36,23,99,73,26,215,149,66,317,213,104,392,217,175,372,173,199,109,36,73
Mia-dong,Gangbuk-gu,1108.0,664,444,7,4,3,32,16,16,50,37,13,76,57,19,127,87,40,239,161,78,280,159,121,233,116,117,64,27,37
Songjung-dong,Gangbuk-gu,1509.0,887,622,10,9,1,34,20,14,44,25,19,96,65,31,194,130,64,318,216,102,372,203,169,348,181,167,93,38,55
Songcheon-dong,Gangbuk-gu,1618.0,941,677,5,5,-,44,25,19,58,42,16,123,79,44,204,139,65,326,211,115,379,215,164,373,186,187,106,39,67
Samgaksan-dong,Gangbuk-gu,1293.0,701,592,22,13,9,45,24,21,36,20,16,110,69,41,203,136,67,258,154,104,260,149,111,278,103,175,81,33,48
Ui-dong,Gangbuk-gu,979.0,549,430,10,7,3,26,16,10,31,22,9,61,45,16,123,86,37,185,116,69,231,125,106,221,100,121,91,32,59
Insu-dong,Gangbuk-gu,1680.0,952,728,15,9,6,43,28,15,52,30,22,108,78,30,216,143,73,346,226,120,384,206,178,381,183,198,135,49,86
Ssangmun 1(il)-dong,Dobong-gu,1028.0,614,414,9,8,1,31,18,13,49,35,14,65,50,15,113,78,35,225,138,87,226,134,92,245,125,120,65,28,37
Ssangmun 2(i)-dong,Dobong-gu,943.0,540,403,7,4,3,27,17,10,29,17,12,65,42,23,124,85,39,197,125,72,201,121,80,197,89,108,96,40,56
Ssangmun 3(sam)-dong,Dobong-gu,799.0,451,348,7,4,3,15,8,7,38,24,14,65,45,20,91,56,35,160,103,57,186,105,81,182,79,103,55,27,28
Ssangmun 4(sa)-dong,Dobong-gu,644.0,369,275,5,3,2,20,16,4,21,16,5,39,29,10,84,57,27,143,92,51,115,68,47,152,60,92,65,28,37
Banghak 1(il)-dong,Dobong-gu,1412.0,847,565,9,4,5,44,23,21,44,30,14,84,64,20,181,128,53,350,240,110,323,178,145,279,137,142,98,43,55
Banghak 2(i)-dong,Dobong-gu,1147.0,690,457,16,11,5,33,23,10,39,25,14,71,51,20,184,139,45,271,188,83,223,126,97,233,106,127,77,21,56
Banghak 3(sam)-dong,Dobong-gu,1010.0,574,436,13,8,5,42,26,16,40,25,15,52,35,17,125,93,32,215,146,69,197,115,82,214,89,125,112,37,75
Chang 1(il)-dong,Dobong-gu,1050.0,600,450,6,3,3,37,22,15,36,26,10,68,52,16,135,97,38,214,132,82,217,123,94,245,113,132,92,32,60
Chang 2(i)-dong,Dobong-gu,1222.0,713,509,15,6,9,33,25,8,46,33,13,81,54,27,174,126,48,260,182,78,287,156,131,248,105,143,78,26,52
Chang 3(sam)-dong,Dobong-gu,731.0,431,300,14,10,4,23,14,9,30,20,10,47,32,15,107,67,40,157,107,50,162,101,61,152,68,84,39,12,27
Chang 4(sa)-dong,Dobong-gu,1012.0,551,461,10,7,3,23,14,9,55,31,24,59,40,19,125,85,40,193,127,66,200,108,92,238,103,135,109,36,73
Chang 5(o)-dong,Dobong-gu,960.0,569,391,7,4,3,30,15,15,48,29,19,61,43,18,116,82,34,200,136,64,196,114,82,206,102,104,96,44,52
Dobong 1(il)-dong,Dobong-gu,1508.0,893,615,7,5,2,45,33,12,77,50,27,106,80,26,166,106,60,333,205,128,351,200,151,313,161,152,110,53,57
Dobong 2(i)-dong,Dobong-gu,1460.0,852,608,13,6,7,23,13,10,52,36,16,82,58,24,161,118,43,303,203,100,362,194,168,348,172,176,116,52,64
Wolgye 1(il)-dong,Nowon-gu,965.0,572,393,11,7,4,20,13,7,29,21,8,61,47,14,94,69,25,216,143,73,239,138,101,210,104,106,85,30,55
Wolgye 2(i)-dong,Nowon-gu,2227.0,1240,987,14,9,5,55,38,17,73,43,30,143,102,41,297,193,104,603,380,223,489,268,221,388,161,227,165,46,119
Wolgye 3(sam)-dong,Nowon-gu,1963.0,1091,872,14,12,2,52,38,14,65,44,21,124,84,40,232,151,81,470,277,193,498,270,228,358,163,195,150,52,98
Gongneung 2(i)-dong,Nowon-gu,1551.0,874,677,16,11,5,56,38,18,53,37,16,103,71,32,195,128,67,349,216,133,336,192,144,310,135,175,133,46,87
Hagye 1(il)-dong,Nowon-gu,2130.0,1090,1040,16,11,5,97,51,46,127,74,53,151,84,67,269,155,114,530,320,210,424,213,211,358,129,229,158,53,105
Hagye 2(i)-dong,Nowon-gu,1075.0,608,467,11,5,6,44,27,17,49,27,22,75,53,22,161,106,55,215,138,77,220,114,106,217,106,111,83,32,51
Junggyebon-dong,Nowon-gu,944.0,537,407,6,5,1,43,26,17,28,18,10,59,34,25,142,105,37,217,152,65,185,86,99,189,86,103,75,25,50
Junggye 1(il)-dong,Nowon-gu,859.0,487,372,8,5,3,48,33,15,36,20,16,31,19,12,162,116,46,180,110,70,129,75,54,191,79,112,74,30,44
Junggye 4(sa)-dong,Nowon-gu,1325.0,754,571,8,4,4,22,14,8,48,33,15,74,55,19,184,126,58,329,205,124,318,171,147,264,119,145,78,27,51
Sanggye 1(il)-dong,Nowon-gu,1929.0,1068,861,22,14,8,54,33,21,116,69,47,138,82,56,201,142,59,402,247,155,437,249,188,379,182,197,180,50,130
Sanggye 2(i)-dong,Nowon-gu,913.0,554,359,13,8,5,19,10,9,38,28,10,59,48,11,111,76,35,187,124,63,195,118,77,200,107,93,91,35,56
Sanggye 5(o)-dong,Nowon-gu,1091.0,604,487,5,3,2,30,20,10,47,31,16,63,42,21,137,104,33,227,130,97,220,120,100,270,121,149,92,33,59
Sanggye 8(pal)-dong,Nowon-gu,786.0,436,350,8,6,2,30,21,9,28,18,10,118,85,33,91,66,25,140,79,61,149,73,76,154,60,94,68,28,40
Sanggye 9(gu)-dong,Nowon-gu,766.0,425,341,13,5,8,26,18,8,31,22,9,47,34,13,111,75,36,165,93,72,147,84,63,139,61,78,87,33,54
Sanggye 10(sip)-dong,Nowon-gu,591.0,323,268,8,5,3,32,17,15,27,21,6,45,33,12,76,52,24,113,70,43,102,57,45,121,47,74,67,21,46
Sanggye 3.4(sam.sa)-dong,Nowon-gu,2160.0,1246,914,16,10,6,33,23,10,66,44,22,148,95,53,280,200,80,450,296,154,549,292,257,479,235,244,139,51,88
Sanggye 6.7(yuk.chil)-dong,Nowon-gu,1236.0,672,564,12,6,6,56,35,21,58,36,22,84,61,23,153,95,58,252,166,86,240,130,110,241,96,145,140,47,93
Junggye 2.3(i.sam)-dong,Nowon-gu,3270.0,1787,1483,25,14,11,95,65,30,107,59,48,201,136,65,419,256,163,775,491,284,739,380,359,658,306,352,251,80,171
Gongneung 1(il)-dong,Nowon-gu,2204.0,1223,981,19,16,3,48,29,19,90,59,31,165,115,50,260,168,92,610,377,233,470,255,215,389,162,227,153,42,111
Nokbeon-dong,Eunpyeong-gu,1388.0,793,595,5,2,3,31,20,11,54,37,17,87,60,27,184,135,49,266,172,94,306,157,149,340,159,181,115,51,64
Bulgwang 1(il)-dong,Eunpyeong-gu,1606.0,901,705,16,11,5,39,31,8,50,31,19,115,88,27,173,119,54,281,177,104,373,209,164,414,172,242,145,63,82
Galhyeon 1(il)-dong,Eunpyeong-gu,1125.0,649,476,6,4,2,30,17,13,43,30,13,77,55,22,161,115,46,243,157,86,249,133,116,228,108,120,88,30,58
Galhyeon 2(i)-dong,Eunpyeong-gu,1093.0,641,452,7,5,2,44,26,18,44,26,18,82,60,22,150,99,51,227,169,58,224,127,97,221,91,130,94,38,56
Gusan-dong,Eunpyeong-gu,2328.0,1745,583,38,18,20,96,49,47,106,80,26,190,161,29,389,341,48,562,468,94,493,375,118,351,211,140,103,42,61
Daejo-dong,Eunpyeong-gu,1338.0,755,583,13,7,6,33,26,7,44,28,16,92,68,24,151,96,55,282,172,110,312,176,136,307,150,157,104,32,72
Eungam 1(il)-dong,Eunpyeong-gu,1356.0,764,592,21,11,10,42,23,19,48,33,15,86,60,26,173,120,53,256,162,94,327,176,151,309,142,167,94,37,57
Eungam 2(i)-dong,Eunpyeong-gu,1102.0,635,467,18,13,5,29,18,11,32,18,14,74,55,19,140,97,43,227,146,81,243,136,107,243,122,121,96,30,66
Sinsa 1(il)-dong,Eunpyeong-gu,1130.0,648,482,13,7,6,32,20,12,54,35,19,75,50,25,160,104,56,248,148,100,252,148,104,215,108,107,81,28,53
Sinsa 2(i)-dong,Eunpyeong-gu,933.0,556,377,12,9,3,34,19,15,33,23,10,49,37,12,125,93,32,182,119,63,233,138,95,200,93,107,65,25,40
Jeungsan-dong,Eunpyeong-gu,860.0,503,357,2,1,1,24,16,8,36,23,13,55,33,22,100,74,26,171,104,67,213,123,90,190,102,88,69,27,42
Susaek-dong,Eunpyeong-gu,984.0,547,437,13,9,4,13,12,1,36,24,12,42,32,10,110,81,29,208,134,74,235,127,108,247,97,150,80,31,49
Jingwan-dong,Eunpyeong-gu,1787.0,980,807,21,17,4,57,30,27,59,42,17,120,75,45,232,167,65,302,191,111,390,226,164,423,178,245,183,54,129
Bulgwang 2(i)-dong,Eunpyeong-gu,1447.0,833,614,9,9,-,41,30,11,48,29,19,94,67,27,172,118,54,297,185,112,335,179,156,325,167,158,126,49,77
Eungam 3(sam)-dong,Eunpyeong-gu,1235.0,733,502,17,8,9,31,24,7,38,28,10,92,73,19,143,90,53,262,170,92,281,153,128,286,152,134,85,35,50
Yeokchon-dong,Eunpyeong-gu,2051.0,1177,874,22,17,5,59,39,20,76,54,22,178,112,66,253,178,75,426,274,152,482,251,231,413,201,212,142,51,91
Cheonyeon-dong,Seodaemun-gu,838.0,447,391,8,6,2,32,19,13,18,15,3,35,24,11,95,65,30,156,103,53,183,98,85,230,98,132,81,19,62
Hongje 1(il)-dong,Seodaemun-gu,1039.0,588,451,13,9,4,35,22,13,32,22,10,50,31,19,123,85,38,217,151,66,242,136,106,242,106,136,85,26,59
Hongje 3(sam)-dong,Seodaemun-gu,952.0,511,441,8,5,3,18,11,7,23,17,6,73,55,18,116,81,35,183,107,76,211,103,108,238,103,135,82,29,53
Hongje 2(i)-dong,Seodaemun-gu,626.0,344,282,8,5,3,19,12,7,21,13,8,30,19,11,69,47,22,126,87,39,150,75,75,156,68,88,47,18,29
Hongeun 1(il)-dong,Seodaemun-gu,1149.0,634,515,14,11,3,33,25,8,26,18,8,61,43,18,128,94,34,241,141,100,249,130,119,286,124,162,111,48,63
Hongeun 2(i)-dong,Seodaemun-gu,1247.0,703,544,10,4,6,29,16,13,45,29,16,80,58,22,171,118,53,239,150,89,266,145,121,297,143,154,110,40,70
Namgajwa 1(il)-dong,Seodaemun-gu,158.0,89,69,2,-,2,4,3,1,3,3,-,8,6,2,17,11,6,31,23,8,33,18,15,48,19,29,12,6,6
Namgajwa 2(i)-dong,Seodaemun-gu,1390.0,766,624,7,5,2,34,26,8,41,28,13,89,51,38,166,115,51,294,175,119,308,167,141,342,162,180,109,37,72
Bukgajwa 1(il)-dong,Seodaemun-gu,681.0,386,295,10,4,6,19,13,6,25,19,6,49,33,16,88,63,25,119,78,41,166,80,86,153,80,73,52,16,36
Bukgajwa 2(i)-dong,Seodaemun-gu,1455.0,828,627,15,8,7,33,24,9,51,40,11,106,77,29,186,124,62,307,186,121,348,194,154,306,132,174,103,43,60
Chunghyeon-dong,Seodaemun-gu,776.0,464,312,3,3,-,15,12,3,19,11,8,52,46,6,100,77,23,159,101,58,159,101,58,182,91,91,87,22,65
Bugahyeon-dong,Seodaemun-gu,450.0,260,190,9,6,3,8,6,2,13,9,4,27,21,6,51,37,14,98,70,28,100,49,51,105,47,58,39,15,24
Sinchon-dong,Seodaemun-gu,537.0,284,253,12,9,3,13,11,2,31,25,6,36,30,6,55,35,20,89,54,35,85,39,46,146,60,86,70,21,49
Yeonhui-dong,Seodaemun-gu,1510.0,849,661,13,9,4,39,27,12,54,36,18,107,74,33,189,138,51,284,174,110,292,153,139,386,188,198,146,50,96
Yonggang-dong,Mapo-gu,549.0,311,238,9,7,2,7,7,-,20,15,5,38,21,17,74,55,19,104,76,28,115,63,52,127,51,76,55,16,39
Daeheung-dong,Mapo-gu,585.0,347,238,8,7,1,10,6,4,32,16,16,56,41,15,63,44,19,106,69,37,119,81,38,141,59,82,50,24,26
Yeomni-dong,Mapo-gu,695.0,364,331,2,2,-,21,10,11,21,12,9,45,29,16,92,61,31,131,81,50,164,78,86,157,72,85,62,19,43
Sinsu-dong,Mapo-gu,776.0,453,323,5,2,3,14,11,3,28,16,12,51,31,20,98,72,26,132,86,46,172,94,78,187,99,88,89,42,47
Seogyo-dong,Mapo-gu,814.0,490,324,5,2,3,15,12,3,37,27,10,70,56,14,117,85,32,149,100,49,174,92,82,171,87,84,76,29,47
Hapjeong-dong,Mapo-gu,652.0,366,286,4,2,2,18,13,5,25,20,5,58,39,19,82,56,26,115,63,52,144,79,65,144,68,76,62,26,36
Mangwon 1(il)-dong,Mapo-gu,966.0,567,399,7,4,3,16,8,8,33,23,10,86,58,28,135,97,38,189,130,59,236,129,107,206,98,108,58,20,38
Mangwon 2(i)-dong,Mapo-gu,841.0,483,358,12,10,2,19,10,9,23,17,6,70,51,19,102,79,23,172,103,69,208,110,98,168,82,86,67,21,46
Yeonnam-dong,Mapo-gu,675.0,382,293,7,7,-,11,6,5,32,24,8,60,37,23,81,59,22,131,89,42,130,70,60,169,75,94,54,15,39
Seongsan 1(il)-dong,Mapo-gu,758.0,438,320,12,6,6,19,8,11,24,19,5,56,41,15,96,61,35,174,108,66,156,94,62,178,84,94,43,17,26
Seongsan 2(i)-dong,Mapo-gu,1977.0,1073,904,29,19,10,72,45,27,74,40,34,123,77,46,247,164,83,405,248,157,458,236,222,433,197,236,136,47,89
Sangam-dong,Mapo-gu,1295.0,723,572,27,17,10,49,32,17,43,26,17,97,68,29,176,124,52,237,151,86,249,131,118,295,135,160,122,39,83
Dohwa-dong,Mapo-gu,821.0,448,373,8,6,2,19,9,10,18,10,8,43,33,10,86,57,29,173,106,67,182,97,85,209,95,114,83,35,48
Seogang-dong,Mapo-gu,732.0,408,324,6,4,2,21,13,8,37,23,14,66,39,27,92,72,20,150,91,59,137,73,64,152,67,85,71,26,45
gongdeok-dong,Mapo-gu,1606.0,950,656,6,4,2,29,19,10,60,34,26,86,58,28,193,143,50,314,215,99,354,211,143,401,193,208,163,73,90
Ahyeon-dong,Mapo-gu,700.0,417,283,3,2,1,16,11,5,17,11,6,52,40,12,74,54,20,148,103,45,148,86,62,173,88,85,69,22,47
Mok 1(il)-dong,Yangcheon-gu,732.0,403,329,11,6,5,28,15,13,36,25,11,49,35,14,97,70,27,138,83,55,140,85,55,153,61,92,80,23,57
Mok 2(i)-dong,Yangcheon-gu,1019.0,609,410,17,11,6,23,14,9,51,39,12,84,60,24,133,100,33,211,145,66,215,123,92,186,82,104,99,35,64
Mok 3(sam)-dong,Yangcheon-gu,888.0,526,362,6,5,1,21,17,4,32,28,4,72,49,23,110,76,34,242,158,84,171,103,68,148,67,81,86,23,63
Mok 4(sa)-dong,Yangcheon-gu,884.0,526,358,10,5,5,23,17,6,35,26,9,62,45,17,153,106,47,180,123,57,181,118,63,170,70,100,70,16,54
Sinwol 1(il)-dong,Yangcheon-gu,1277.0,796,481,9,4,5,29,19,10,41,23,18,98,74,24,179,109,70,336,237,99,299,185,114,218,120,98,68,25,43
Sinwol 2(i)-dong,Yangcheon-gu,950.0,548,402,9,7,2,20,13,7,37,22,15,57,30,27,104,71,33,241,152,89,231,145,86,197,91,106,54,17,37
Sinwol 3(sam)-dong,Yangcheon-gu,910.0,560,350,9,7,2,24,12,12,39,28,11,68,47,21,144,112,32,232,157,75,199,115,84,164,74,90,31,8,23
Sinwol 4(sa)-dong,Yangcheon-gu,833.0,504,329,9,6,3,21,13,8,30,20,10,74,46,28,94,66,28,182,116,66,215,127,88,146,77,69,62,33,29
Sinwol 5(o)-dong,Yangcheon-gu,765.0,432,333,6,2,4,27,16,11,36,27,9,34,25,9,86,61,25,186,118,68,193,109,84,142,57,85,55,17,38
Sinwol 6(yuk)-dong,Yangcheon-gu,583.0,385,198,5,3,2,13,8,5,29,23,6,40,27,13,80,57,23,139,111,28,143,88,55,95,49,46,39,19,20
Sinwol 7(chil)-dong,Yangcheon-gu,1129.0,656,473,11,7,4,18,9,9,38,27,11,74,56,18,137,97,40,254,155,99,261,156,105,243,109,134,93,40,53
Sinjeong 1(il)-dong,Yangcheon-gu,482.0,307,175,6,4,2,18,11,7,15,12,3,38,24,14,59,45,14,95,69,26,110,78,32,92,48,44,49,16,33
Sinjeong 2(i)-dong,Yangcheon-gu,811.0,474,337,8,6,2,24,17,7,42,29,13,36,23,13,95,63,32,194,142,52,179,103,76,165,68,97,68,23,45
Sinjeong 3(sam)-dong,Yangcheon-gu,2371.0,1371,1000,26,18,8,69,52,17,81,54,27,163,99,64,322,230,92,521,339,182,530,296,234,482,224,258,177,59,118
Sinjeong 6(yuk)-dong,Yangcheon-gu,528.0,282,246,5,4,1,43,27,16,29,18,11,19,11,8,64,43,21,99,60,39,91,55,36,104,49,55,74,15,59
Sinjeong 7(chil)-dong,Yangcheon-gu,1374.0,718,656,8,5,3,41,28,13,43,31,12,72,46,26,179,114,65,307,185,122,283,146,137,298,122,176,143,41,102
Mok 5(o)-dong,Yangcheon-gu,744.0,404,340,9,5,4,33,22,11,26,19,7,36,24,12,112,81,31,122,82,40,114,69,45,170,58,112,122,44,78
Sinjeong 4(sa)-dong,Yangcheon-gu,1624.0,1000,624,16,12,4,40,24,16,55,39,16,132,96,36,197,145,52,360,235,125,423,261,162,307,158,149,94,30,64
Yeomchang-dong,Gangseo-gu,1191.0,714,477,21,11,10,49,34,15,39,25,14,99,74,25,146,112,34,261,189,72,224,126,98,254,113,141,98,30,68
Deungchon 1(il)-dong,Gangseo-gu,769.0,420,349,5,2,3,20,13,7,38,26,12,65,47,18,93,62,31,170,98,72,138,81,57,153,65,88,87,26,61
Deungchon 2(i)-dong,Gangseo-gu,728.0,410,318,6,3,3,25,15,10,20,13,7,55,42,13,88,59,29,161,94,67,163,91,72,147,75,72,63,18,45
Deungchon 3(sam)-dong,Gangseo-gu,3682.0,2055,1627,14,10,4,86,54,32,144,94,50,180,108,72,624,368,256,1078,684,394,735,420,315,536,225,311,285,92,193
Hwagokbon-dong,Gangseo-gu,1454.0,872,582,15,11,4,36,24,12,60,46,14,137,102,35,228,155,73,327,204,123,309,181,128,232,114,118,110,35,75
Hwagok 2(i)-dong,Gangseo-gu,784.0,504,280,11,9,2,16,9,7,28,22,6,64,42,22,100,73,27,179,124,55,202,132,70,140,79,61,44,14,30
Hwagok 3(sam)-dong,Gangseo-gu,868.0,509,359,4,1,3,20,14,6,47,38,9,54,43,11,93,65,28,189,125,64,208,116,92,173,84,89,80,23,57
Hwagok 4(sa)-dong,Gangseo-gu,961.0,566,395,5,4,1,28,15,13,34,24,10,84,53,31,137,90,47,209,135,74,209,124,85,185,96,89,70,25,45
Hwagok 6(yuk)-dong,Gangseo-gu,987.0,565,422,6,3,3,49,28,21,68,45,23,104,70,34,107,72,35,231,140,91,203,121,82,143,61,82,76,25,51
Hwagok 8(pal)-dong,Gangseo-gu,1060.0,626,434,9,8,1,18,13,5,25,16,9,100,79,21,145,107,38,198,110,88,298,176,122,198,93,105,69,24,45
Gayang 1(il)-dong,Gangseo-gu,704.0,414,290,11,6,5,27,21,6,28,20,8,59,36,23,92,73,19,166,113,53,130,76,54,127,56,71,64,13,51
Gayang 2(i)-dong,Gangseo-gu,2324.0,1331,993,3,2,1,48,23,25,87,48,39,117,80,37,290,183,107,818,539,279,459,283,176,320,127,193,182,46,136
Gayang 3(sam)-dong,Gangseo-gu,1646.0,894,752,5,1,4,22,13,9,52,36,16,114,78,36,216,137,79,496,288,208,352,191,161,265,112,153,124,38,86
Balsan 1(il)-dong,Gangseo-gu,1242.0,732,510,13,9,4,43,29,14,38,21,17,87,61,26,185,116,69,320,213,107,240,131,109,227,113,114,89,39,50
Gonghang-dong,Gangseo-gu,983.0,593,390,6,-,6,16,13,3,34,27,7,91,64,27,132,87,45,240,159,81,211,121,90,172,90,82,81,32,49
Banghwa 1(il)-dong,Gangseo-gu,1271.0,755,516,14,9,5,26,17,9,47,33,14,88,69,19,155,120,35,278,183,95,305,172,133,243,111,132,115,41,74
Banghwa 2(i)-dong,Gangseo-gu,1553.0,920,633,6,4,2,18,9,9,50,34,16,111,81,30,201,132,69,379,257,122,388,233,155,297,132,165,103,38,65
Banghwa 3(sam)-dong,Gangseo-gu,2006.0,1146,860,9,7,2,38,25,13,50,36,14,125,87,38,256,160,96,538,335,203,460,285,175,377,162,215,153,49,104
Hwagok 1(il)-dong,Gangseo-gu,2110.0,1300,810,13,8,5,42,29,13,78,62,16,190,137,53,245,178,67,497,321,176,559,315,244,363,201,162,123,49,74
Ujangsan-dong,Gangseo-gu,1186.0,678,508,13,8,5,31,19,12,74,42,32,87,54,33,147,96,51,264,191,73,255,147,108,224,104,120,91,17,74
Sindorim-dong,Guro-gu,1009.0,586,423,18,13,5,38,22,16,46,29,17,81,57,24,99,60,39,197,127,70,223,134,89,224,116,108,83,28,55
Guro 1(il)-dong,Guro-gu,569.0,343,226,6,3,3,20,18,2,19,16,3,37,25,12,59,38,21,124,85,39,124,78,46,117,54,63,63,26,37
Guro 3(sam)-dong,Guro-gu,938.0,569,369,14,7,7,19,10,9,48,31,17,87,65,22,116,88,28,191,124,67,203,122,81,200,94,106,60,28,32
Guro 4(sa)-dong,Guro-gu,1310.0,775,535,13,10,3,33,25,8,45,23,22,103,74,29,176,126,50,288,185,103,316,183,133,263,122,141,73,27,46
Guro 5(o)-dong,Guro-gu,1178.0,701,477,12,9,3,39,26,13,51,32,19,95,64,31,142,99,43,262,177,85,277,157,120,229,106,123,71,31,40
Gocheok 1(il)-dong,Guro-gu,1108.0,673,435,9,6,3,27,17,10,50,38,12,64,44,20,128,90,38,253,180,73,262,151,111,241,121,120,74,26,48
Gocheok 2(i)-dong,Guro-gu,1312.0,788,524,12,11,1,38,27,11,38,21,17,102,74,28,162,118,44,322,204,118,293,171,122,256,132,124,89,30,59
Gaebong 2(i)-dong,Guro-gu,1353.0,841,512,13,6,7,48,33,15,56,40,16,111,84,27,150,92,58,302,210,92,344,205,139,246,137,109,83,34,49
Gaebong 3(sam)-dong,Guro-gu,902.0,566,336,8,6,2,26,15,11,37,22,15,71,47,24,104,72,32,187,139,48,241,145,96,164,94,70,64,26,38
Oryu 1(il)-dong,Guro-gu,1015.0,618,397,3,1,2,12,5,7,49,31,18,72,57,15,112,74,38,242,159,83,234,139,95,214,119,95,77,33,44
Oryu 2(i)-dong,Guro-gu,1865.0,1082,783,20,11,9,69,42,27,84,55,29,159,111,48,239,154,85,371,238,133,422,247,175,362,178,184,139,46,93
Sugung-dong,Guro-gu,1187.0,723,464,13,9,4,45,31,14,74,49,25,82,55,27,159,114,45,239,160,79,297,189,108,204,93,111,74,23,51
Garibong-dong,Guro-gu,790.0,495,295,2,2,-,20,10,10,23,15,8,54,34,20,115,80,35,225,161,64,156,107,49,137,67,70,58,19,39
Guro 2(i)-dong,Guro-gu,1551.0,917,634,11,7,4,39,24,15,36,25,11,124,93,31,199,136,63,334,215,119,386,230,156,343,153,190,79,34,45
Gaebong 1(il)-dong,Guro-gu,1533.0,963,570,14,9,5,40,29,11,59,44,15,117,91,26,191,138,53,320,219,101,381,228,153,319,174,145,92,31,61
Gasan-dong,Geumcheon-gu,809.0,534,275,2,1,1,12,11,1,37,28,9,66,54,12,114,84,30,183,134,49,202,121,81,136,78,58,57,23,34
Doksan 1(il)-dong,Geumcheon-gu,1747.0,1069,678,12,6,6,28,19,9,76,53,23,124,82,42,252,173,79,380,267,113,412,242,170,353,180,173,110,47,63
Doksan 2(i)-dong,Geumcheon-gu,956.0,588,368,10,8,2,28,23,5,41,28,13,74,54,20,151,102,49,241,164,77,189,112,77,169,75,94,53,22,31
Doksan 3(sam)-dong,Geumcheon-gu,1265.0,778,487,11,9,2,27,18,9,42,24,18,106,81,25,171,116,55,332,204,128,310,193,117,208,108,100,58,25,33
Doksan 4(sa)-dong,Geumcheon-gu,761.0,503,258,5,4,1,29,17,12,32,26,6,52,43,9,143,105,38,169,126,43,176,110,66,121,60,61,34,12,22
Siheung 1(il)-dong,Geumcheon-gu,1587.0,973,614,13,9,4,37,27,10,51,32,19,116,83,33,232,165,67,359,242,117,367,222,145,300,153,147,112,40,72
Siheung 2(i)-dong,Geumcheon-gu,1166.0,680,486,9,5,4,33,20,13,33,25,8,71,48,23,166,115,51,289,188,101,249,144,105,231,105,126,85,30,55
Siheung 3(sam)-dong,Geumcheon-gu,652.0,379,273,2,2,-,9,6,3,25,15,10,42,34,8,86,54,32,145,93,52,151,91,60,146,73,73,46,11,35
Siheung 4(sa)-dong,Geumcheon-gu,1045.0,643,402,8,8,-,26,15,11,41,26,15,74,57,17,145,100,45,256,184,72,233,136,97,198,94,104,64,23,41
Siheung 5(o)-dong,Geumcheon-gu,1196.0,707,489,5,2,3,36,24,12,31,22,9,81,59,22,178,123,55,276,188,88,267,148,119,232,115,117,90,26,64
Yeouido-dong,Yeongdeungpo-gu,712.0,415,297,11,8,3,32,20,12,39,26,13,41,30,11,57,41,16,120,80,40,134,81,53,169,89,80,109,40,69
Dangsan 1(il)-dong,Yeongdeungpo-gu,849.0,498,351,6,5,1,19,10,9,27,19,8,76,56,20,89,70,19,176,119,57,190,97,93,186,88,98,80,34,46
Dangsan2(i)-dong,Yeongdeungpo-gu,987.0,569,418,17,10,7,15,11,4,37,25,12,74,51,23,92,66,26,178,127,51,237,132,105,225,114,111,112,33,79
Yangpyeong 1(il)-dong,Yeongdeungpo-gu,784.0,468,316,11,4,7,15,5,10,23,20,3,58,42,16,82,56,26,144,103,41,194,112,82,184,101,83,73,25,48
Yangpyeong 2(i)-dong,Yeongdeungpo-gu,683.0,417,266,4,4,-,20,13,7,28,21,7,43,33,10,93,72,21,143,96,47,148,87,61,138,70,68,66,21,45
Singil 1(il)-dong,Yeongdeungpo-gu,999.0,571,428,3,3,-,19,9,10,36,24,12,57,39,18,129,90,39,204,138,66,225,124,101,245,119,126,81,25,56
Singil 3(sam)-dong,Yeongdeungpo-gu,800.0,483,317,9,6,3,20,13,7,27,18,9,56,43,13,112,84,28,174,115,59,188,106,82,154,70,84,60,28,32
Singil 4(sa)-dong,Yeongdeungpo-gu,660.0,390,270,9,6,3,12,7,5,19,14,5,44,35,9,82,62,20,155,104,51,130,67,63,146,66,80,63,29,34
Singil 5(o)-dong,Yeongdeungpo-gu,810.0,480,330,12,12,-,26,18,8,19,11,8,52,39,13,90,63,27,177,111,66,192,117,75,185,87,98,57,22,35
Singil 6(yuk)-dong,Yeongdeungpo-gu,1016.0,582,434,9,6,3,30,22,8,40,28,12,72,43,29,122,83,39,197,121,76,255,146,109,216,106,110,75,27,48
Singil 7(chil)-dong,Yeongdeungpo-gu,480.0,254,226,4,1,3,28,15,13,19,7,12,32,23,9,39,26,13,103,70,33,106,59,47,115,43,72,34,10,24
Daerim 1(il)-dong,Yeongdeungpo-gu,817.0,499,318,8,7,1,23,16,7,28,19,9,51,35,16,103,69,34,193,139,54,187,112,75,168,91,77,56,11,45
Daerim 2(i)-dong,Yeongdeungpo-gu,797.0,506,291,4,2,2,22,15,7,21,15,6,47,37,10,109,80,29,181,124,57,198,125,73,163,87,76,52,21,31
Daerim 3(sam)-dong,Yeongdeungpo-gu,1181.0,718,463,6,1,5,27,21,6,50,30,20,87,67,20,150,107,43,256,170,86,258,154,104,268,145,123,79,23,56
Yeongdeungpobon-dong,Yeongdeungpo-gu,1119.0,689,430,10,9,1,22,15,7,35,23,12,83,60,23,116,87,29,273,191,82,250,159,91,239,108,131,91,37,54
Yeongdeungpo-dong,Yeongdeungpo-gu,1066.0,743,323,3,1,2,9,5,4,40,26,14,89,69,20,145,125,20,311,246,65,229,157,72,176,88,88,64,26,38
Dorim-dong,Yeongdeungpo-gu,858.0,514,344,4,2,2,18,13,5,27,18,9,58,41,17,120,86,34,178,126,52,195,115,80,190,89,101,68,24,44
Mullae-dong,Yeongdeungpo-gu,1018.0,582,436,11,8,3,20,15,5,37,22,15,76,47,29,116,89,27,155,88,67,268,160,108,245,120,125,90,33,57
Noryangjin 2(i)-dong,Dongjak-gu,680.0,384,296,8,5,3,14,11,3,27,17,10,51,33,18,86,58,28,143,89,54,156,85,71,147,69,78,48,17,31
Sangdo 1(il)-dong,Dongjak-gu,1601.0,905,696,22,13,9,31,19,12,67,46,21,155,105,50,197,129,68,296,180,116,351,198,153,334,162,172,148,53,95
Sangdo 2(i)-dong,Dongjak-gu,978.0,564,414,21,14,7,40,20,20,46,34,12,66,43,23,109,69,40,173,113,60,217,123,94,215,110,105,91,38,53
Sangdo 3(sam)-dong,Dongjak-gu,1168.0,689,479,13,12,1,26,17,9,45,32,13,91,59,32,138,96,42,196,118,78,319,185,134,255,130,125,85,40,45
Sangdo 4(sa)-dong,Dongjak-gu,1279.0,761,518,28,19,9,97,58,39,76,45,31,88,66,22,153,109,44,233,153,80,256,138,118,273,142,131,75,31,44
Sadang 1(il)-dong,Dongjak-gu,789.0,463,326,3,-,3,18,10,8,28,20,8,64,47,17,98,62,36,173,113,60,210,126,84,144,72,72,51,13,38
Sadang 3(sam)-dong,Dongjak-gu,836.0,480,356,8,5,3,18,10,8,32,24,8,71,45,26,83,54,29,143,97,46,221,118,103,199,111,88,61,16,45
Sadang 4(sa)-dong,Dongjak-gu,564.0,331,233,4,1,3,12,9,3,16,11,5,45,33,12,72,52,20,122,76,46,142,80,62,114,58,56,37,11,26
Sadang 5(o)-dong,Dongjak-gu,562.0,313,249,14,6,8,11,8,3,22,18,4,46,26,20,65,40,25,115,75,40,115,60,55,127,59,68,47,21,26
Daebang-dong,Dongjak-gu,1599.0,892,707,12,10,2,55,29,26,50,32,18,106,74,32,201,133,68,375,224,151,359,196,163,304,150,154,137,44,93
Sindaebang 1(il)-dong,Dongjak-gu,842.0,486,356,4,1,3,38,28,10,39,27,12,57,45,12,106,69,37,172,108,64,177,100,77,183,82,101,66,26,40
Sindaebang 2(i)-dong,Dongjak-gu,757.0,467,290,13,11,2,20,15,5,25,15,10,59,46,13,84,61,23,153,106,47,158,98,60,186,90,96,59,25,34
Heukseok-dong,Dongjak-gu,1446.0,805,641,12,7,5,22,15,7,57,36,21,98,68,30,161,116,45,251,170,81,347,178,169,374,179,195,124,36,88
Noryangjin 1(il)-dong,Dongjak-gu,1276.0,738,538,8,5,3,27,19,8,49,36,13,86,66,20,130,87,43,277,173,104,273,158,115,311,150,161,115,44,71
Sadang 2(i)-dong,Dongjak-gu,950.0,545,405,8,4,4,22,19,3,35,22,13,58,43,15,97,61,36,196,121,75,239,135,104,215,121,94,80,19,61
Boramae-dong,Gwanak-gu,1124.0,634,490,12,9,3,36,25,11,52,32,20,85,51,34,128,86,42,215,135,80,262,154,108,234,117,117,100,25,75
Cheongnim-dong,Gwanak-gu,651.0,366,285,6,1,5,10,8,2,20,16,4,52,37,15,90,64,26,117,75,42,172,94,78,134,56,78,50,15,35
Haengun-dong,Gwanak-gu,1189.0,711,478,10,6,4,25,13,12,49,29,20,98,74,24,155,111,44,250,160,90,278,170,108,240,118,122,84,30,54
Nagseongdae-dong,Gwanak-gu,560.0,318,242,3,3,-,11,8,3,31,21,10,53,33,20,57,36,21,102,68,34,141,78,63,122,63,59,40,8,32
Jungang-dong,Gwanak-gu,653.0,384,269,4,2,2,14,9,5,25,16,9,62,43,19,69,54,15,136,81,55,138,74,64,168,93,75,37,12,25
Inheon-dong,Gwanak-gu,989.0,572,417,7,4,3,17,10,7,42,34,8,77,55,22,129,81,48,210,138,72,235,122,113,217,110,107,55,18,37
Namhyeon-dong,Gwanak-gu,569.0,327,242,6,3,3,11,7,4,37,24,13,53,38,15,62,49,13,103,68,35,146,71,75,107,55,52,44,12,32
Sewon-dong,Gwanak-gu,837.0,490,347,4,3,1,14,8,6,46,32,14,83,57,26,96,63,33,200,116,84,189,115,74,160,79,81,45,17,28
Sinwon-dong,Gwanak-gu,867.0,504,363,7,3,4,17,12,5,40,24,16,70,56,14,128,87,41,154,102,52,216,126,90,193,81,112,42,13,29
Serim-dong,Gwanak-gu,844.0,520,324,5,4,1,17,11,6,36,24,12,81,57,24,109,83,26,179,120,59,195,116,79,170,87,83,52,18,34
Sinsa-dong,Gwanak-gu,951.0,580,371,9,3,6,17,10,7,45,28,17,101,73,28,148,107,41,214,138,76,197,113,84,149,85,64,71,23,48
Sillim-dong,Gwanak-gu,540.0,325,215,4,3,1,6,3,3,41,27,14,77,56,21,73,50,23,90,46,44,127,75,52,101,57,44,21,8,13
Nanhyang-dong,Gwanak-gu,723.0,437,286,7,4,3,30,21,9,25,14,11,55,36,19,97,71,26,152,105,47,162,93,69,152,81,71,43,12,31
Jowon-dong,Gwanak-gu,739.0,489,250,4,3,1,10,7,3,18,14,4,50,38,12,82,66,16,194,137,57,180,122,58,156,88,68,45,14,31
Daehak-dong,Gwanak-gu,653.0,394,259,4,1,3,9,4,5,29,17,12,59,48,11,74,53,21,142,91,51,144,83,61,144,78,66,48,19,29
Euncheon-dong,Gwanak-gu,1677.0,997,680,11,6,5,43,31,12,64,38,26,135,94,41,239,160,79,372,246,126,392,225,167,325,163,162,96,34,62
Seonghyeon-dong,Gwanak-gu,1520.0,869,651,11,6,5,37,26,11,59,42,17,106,77,29,207,141,66,322,212,110,348,179,169,321,145,176,109,41,68
Cheongnyong-dong,Gwanak-gu,1264.0,715,549,6,2,4,17,12,5,64,32,32,109,79,30,152,100,52,249,157,92,308,161,147,287,144,143,72,28,44
Nangok-dong,Gwanak-gu,1532.0,909,623,20,12,8,36,23,13,53,40,13,105,70,35,209,134,75,342,235,107,366,217,149,310,146,164,91,32,59
Samseong-dong,Gwanak-gu,1596.0,902,694,11,9,2,39,28,11,56,36,20,105,86,19,178,125,53,331,207,124,383,206,177,363,164,199,130,41,89
Miseong-dong,Gwanak-gu,1374.0,817,557,10,7,3,38,23,15,43,23,20,91,69,22,177,124,53,335,226,109,345,193,152,253,122,131,82,30,52
Seocho 1(il)-dong,Seocho-gu,486.0,286,200,2,1,1,16,13,3,25,17,8,39,24,15,61,42,19,89,64,25,100,57,43,102,50,52,52,18,34
Seocho 2(i)-dong,Seocho-gu,435.0,251,184,6,3,3,11,8,3,19,12,7,34,24,10,49,40,9,84,55,29,99,56,43,89,43,46,44,10,34
Seocho 3(sam)-dong,Seocho-gu,690.0,418,272,9,7,2,19,15,4,40,33,7,40,32,8,73,47,26,121,76,45,161,90,71,149,83,66,78,35,43
Seocho 4(sa)-dong,Seocho-gu,437.0,242,195,12,9,3,14,9,5,25,16,9,43,31,12,47,32,15,59,40,19,80,47,33,84,32,52,73,26,47
Jamwon-dong,Seocho-gu,615.0,358,257,9,7,2,23,12,11,31,23,8,42,31,11,76,55,21,137,90,47,110,63,47,98,44,54,89,33,56
Banpobon-dong,Seocho-gu,228.0,143,85,2,2,-,20,17,3,6,5,1,10,8,2,29,22,7,28,20,8,37,24,13,66,38,28,30,7,23
Banpo 1(il)-dong,Seocho-gu,629.0,358,271,4,2,2,18,13,5,31,19,12,61,44,17,79,61,18,122,78,44,132,67,65,123,62,61,59,12,47
Banpo 2(i)-dong,Seocho-gu,315.0,191,124,5,4,1,13,8,5,20,16,4,18,12,6,35,26,9,50,34,16,61,38,23,73,44,29,40,9,31
Banpo 3(sam)-dong,Seocho-gu,427.0,227,200,6,3,3,23,13,10,16,8,8,34,18,16,39,26,13,50,36,14,87,53,34,98,45,53,74,25,49
Banpo 4(sa)-dong,Seocho-gu,374.0,205,169,1,1,-,8,6,2,20,13,7,22,13,9,52,30,22,67,40,27,78,51,27,69,35,34,57,16,41
Bangbaebon-dong,Seocho-gu,519.0,290,229,8,5,3,14,10,4,19,11,8,42,30,12,81,53,28,84,58,26,95,47,48,112,52,60,64,24,40
Bangbae 1(il)-dong,Seocho-gu,464.0,253,211,3,3,-,9,3,6,19,11,8,45,28,17,56,34,22,103,65,38,105,53,52,85,44,41,39,12,27
Bangbae 2(i)-dong,Seocho-gu,917.0,514,403,6,3,3,23,17,6,38,24,14,61,41,20,103,65,38,206,135,71,229,120,109,188,94,94,63,15,48
Bangbae 3(sam)-dong,Seocho-gu,616.0,375,241,2,1,1,22,17,5,25,18,7,49,37,12,65,53,12,121,76,45,134,82,52,127,68,59,71,23,48
Bangbae 4(sa)-dong,Seocho-gu,660.0,393,267,9,5,4,15,8,7,25,15,10,56,43,13,87,59,28,132,84,48,150,84,66,125,73,52,61,22,39
Yangjae 1(il)-dong,Seocho-gu,1859.0,1046,813,27,17,10,59,33,26,66,36,30,138,93,45,211,146,65,448,280,168,439,249,190,317,141,176,154,51,103
Yangjae 2(i)-dong,Seocho-gu,693.0,422,271,8,4,4,21,16,5,24,17,7,69,51,18,95,68,27,147,97,50,140,83,57,129,66,63,60,20,40
Naegok-dong,Seocho-gu,419.0,293,126,14,12,2,67,66,1,36,28,8,32,28,4,35,26,9,53,32,21,86,54,32,63,32,31,33,15,18
Sinsa-dong,Gangnam-gu,401.0,220,181,1,1,-,9,5,4,12,6,6,27,19,8,44,32,12,73,42,31,82,48,34,100,47,53,53,20,33
Nonhyeon 1(il)-dong,Gangnam-gu,677.0,404,273,8,3,5,14,10,4,50,38,12,84,60,24,90,57,33,131,80,51,145,84,61,103,49,54,52,23,29
Nonhyeon 2(i)-dong,Gangnam-gu,559.0,340,219,2,1,1,16,12,4,24,17,7,69,46,23,54,41,13,101,63,38,144,94,50,98,48,50,51,18,33
Samseong 1(il)-dong,Gangnam-gu,364.0,221,143,6,4,2,12,8,4,17,13,4,24,15,9,53,34,19,68,45,23,81,53,28,64,36,28,39,13,26
Samseong 2(i)-dong,Gangnam-gu,648.0,374,274,10,8,2,27,19,8,26,18,8,64,47,17,77,50,27,110,74,36,125,74,51,130,60,70,79,24,55
Daechi 1(il)-dong,Gangnam-gu,246.0,143,103,3,2,1,20,15,5,15,10,5,10,7,3,38,26,12,46,32,14,24,11,13,51,27,24,39,13,26
Daechi 4(sa)-dong,Gangnam-gu,404.0,224,180,8,8,-,12,6,6,24,18,6,48,36,12,61,35,26,72,47,25,68,22,46,73,39,34,38,13,25
Yeoksam 1(il)-dong,Gangnam-gu,811.0,466,345,5,4,1,17,11,6,42,25,17,104,82,22,109,75,34,162,88,74,175,89,86,123,72,51,74,20,54
Yeoksam 2(i)-dong,Gangnam-gu,659.0,402,257,9,4,5,16,15,1,30,25,5,84,61,23,88,56,32,127,88,39,134,70,64,104,56,48,67,27,40
Dogok 1(il)-dong,Gangnam-gu,447.0,254,193,7,7,-,18,11,7,23,16,7,28,17,11,47,32,15,89,55,34,85,58,27,101,46,55,49,12,37
Dogok 2(i)-dong,Gangnam-gu,520.0,307,213,7,5,2,28,18,10,22,14,8,43,27,16,63,47,16,89,61,28,97,62,35,98,47,51,73,26,47
Gaepo 1(il)-dong,Gangnam-gu,672.0,384,288,10,6,4,23,10,13,37,25,12,33,22,11,76,47,29,147,97,50,154,99,55,121,58,63,71,20,51
Gaepo 4(sa)-dong,Gangnam-gu,662.0,376,286,11,9,2,32,17,15,35,27,8,53,42,11,90,54,36,153,92,61,127,69,58,98,49,49,63,17,46
Irwonbon-dong,Gangnam-gu,598.0,314,284,14,7,7,68,57,11,43,29,14,30,20,10,78,35,43,117,49,68,105,59,46,76,35,41,67,23,44
Irwon 1(il)-dong,Gangnam-gu,1104.0,618,486,15,13,2,40,28,12,39,23,16,73,54,19,117,74,43,274,165,109,261,153,108,191,87,104,94,21,73
Irwon 2(i)-dong,Gangnam-gu,1152.0,609,543,14,9,5,39,24,15,40,27,13,64,40,24,124,84,40,265,151,114,338,185,153,190,68,122,78,21,57
Suseo-dong,Gangnam-gu,2062.0,1127,935,8,7,1,31,24,7,76,51,25,112,69,43,234,138,96,632,382,250,499,272,227,317,139,178,153,45,108
Segok-dong,Gangnam-gu,1025.0,602,423,28,16,12,51,33,18,32,24,8,69,51,18,138,99,39,180,113,67,191,118,73,225,105,120,111,43,68
Apgujeong -dong,Gangnam-gu,536.0,302,234,7,2,5,14,11,3,24,18,6,33,22,11,56,43,13,78,49,29,104,53,51,123,66,57,97,38,59
Cheongdam -dong,Gangnam-gu,661.0,387,274,7,5,2,21,12,9,36,24,12,51,38,13,79,57,22,118,80,38,135,73,62,129,68,61,85,30,55
Daechi 2(i)-dong,Gangnam-gu,712.0,434,278,9,6,3,45,32,13,48,39,9,41,32,9,89,62,27,138,95,43,138,86,52,123,61,62,81,21,60
Gaepo 2(i)-dong,Gangnam-gu,787.0,438,349,7,5,2,39,29,10,40,30,10,76,51,25,98,62,36,150,93,57,163,100,63,145,52,93,69,16,53
Pungnap 1(il)-dong,Songpa-gu,777.0,463,314,8,6,2,29,23,6,29,22,7,53,36,17,85,53,32,164,114,50,206,115,91,157,78,79,46,16,30
Pungnap 2(i)-dong,Songpa-gu,864.0,528,336,12,7,5,26,19,7,39,26,13,56,38,18,109,82,27,194,123,71,202,124,78,157,78,79,69,31,38
Geoyeo 1(il)-dong,Songpa-gu,639.0,389,250,10,8,2,22,15,7,27,18,9,43,30,13,84,55,29,147,96,51,139,91,48,120,64,56,47,12,35
Geoyeo 2(i)-dong,Songpa-gu,1273.0,747,526,12,8,4,27,19,8,62,45,17,132,100,32,219,135,84,280,172,108,251,146,105,219,99,120,71,23,48
Macheon 1(il)-dong,Songpa-gu,1207.0,685,522,15,13,2,38,26,12,47,28,19,75,56,19,154,103,51,273,175,98,277,149,128,239,103,136,89,32,57
Macheon 2(i)-dong,Songpa-gu,1136.0,694,442,8,5,3,41,30,11,28,16,12,62,46,16,171,125,46,278,185,93,268,159,109,210,109,101,70,19,51
Bangi 1(il)-dong,Songpa-gu,463.0,275,188,5,4,1,21,14,7,23,18,5,42,28,14,64,47,17,79,53,26,85,49,36,101,50,51,43,12,31
Bangi 2(i)-dong,Songpa-gu,857.0,514,343,11,5,6,21,13,8,38,28,10,78,57,21,105,78,27,178,111,67,212,128,84,140,65,75,74,29,45
Oryun-dong,Songpa-gu,349.0,197,152,6,5,1,24,17,7,26,16,10,17,14,3,43,34,9,42,19,23,47,36,11,84,33,51,60,23,37
Ogeum-dong,Songpa-gu,1233.0,704,529,11,8,3,60,34,26,67,52,15,73,51,22,169,117,52,261,168,93,251,141,110,215,92,123,126,41,85
Songpa 1(il)-dong,Songpa-gu,761.0,446,315,4,-,4,15,11,4,30,22,8,61,46,15,94,57,37,180,122,58,184,111,73,140,61,79,53,16,37
Songpa 2(i)-dong,Songpa-gu,587.0,336,251,5,4,1,24,19,5,34,26,8,53,36,17,71,50,21,103,69,34,120,71,49,122,49,73,55,12,43
Seokchon-dong,Songpa-gu,1108.0,663,445,13,13,-,37,27,10,45,29,16,107,77,30,143,102,41,245,151,94,231,137,94,214,104,110,73,23,50
Samjeon-dong,Songpa-gu,1028.0,588,440,7,2,5,24,18,6,51,38,13,115,85,30,133,92,41,249,151,98,203,119,84,164,64,100,82,19,63
Garakbon-dong,Songpa-gu,809.0,491,318,11,9,2,29,22,7,50,34,16,59,42,17,89,75,14,203,139,64,160,91,69,148,63,85,60,16,44
Garak 1(il)-dong,Songpa-gu,42.0,28,14,2,2,-,2,2,-,3,3,-,1,-,1,4,3,1,8,6,2,11,6,5,8,5,3,3,1,2
Garak 2(i)-dong,Songpa-gu,916.0,529,387,10,6,4,34,24,10,45,32,13,71,50,21,126,94,32,189,126,63,183,103,80,183,69,114,75,25,50
Munjeong 1(il)-dong,Songpa-gu,613.0,345,268,10,9,1,32,21,11,33,19,14,54,38,16,71,49,22,110,61,49,133,82,51,120,51,69,50,15,35
Munjeong 2(i)-dong,Songpa-gu,396.0,225,171,3,3,-,19,13,6,20,16,4,25,15,10,22,14,8,66,41,25,89,56,33,92,51,41,60,16,44
Jangji-dong,Songpa-gu,1625.0,964,661,32,19,13,91,61,30,100,71,29,146,111,35,228,158,70,358,244,114,305,170,135,255,104,151,110,26,84
Jamsilbon-dong,Songpa-gu,903.0,519,384,16,11,5,17,11,6,45,32,13,87,68,19,131,96,35,185,117,68,196,103,93,156,62,94,70,19,51
Jamsil 4(sa)-dong,Songpa-gu,648.0,372,276,22,14,8,17,14,3,17,14,3,59,46,13,78,51,27,120,72,48,125,77,48,131,59,72,79,25,54
Jamsil 6(yuk)-dong,Songpa-gu,374.0,222,152,5,5,-,16,10,6,21,15,6,22,16,6,34,27,7,76,61,15,80,47,33,69,25,44,51,16,35
Jamsil 7(chil)-dong,Songpa-gu,194.0,107,87,2,-,2,9,7,2,7,5,2,10,4,6,16,11,5,20,11,9,46,33,13,49,21,28,35,15,20
Jamsil 2(i)-dong,Songpa-gu,611.0,335,276,14,9,5,27,16,11,32,21,11,48,31,17,89,62,27,93,52,41,127,68,59,130,62,68,51,14,37
Jamsil 3(sam)-dong,Songpa-gu,746.0,437,309,6,5,1,22,14,8,35,24,11,59,44,15,83,59,24,122,76,46,181,109,72,143,75,68,95,31,64
Gangil-dong,Gangdong-gu,1514.0,881,633,36,25,11,78,54,24,59,37,22,93,65,28,203,153,50,306,198,108,292,160,132,314,146,168,133,43,90
Sangil-dong,Gangdong-gu,985.0,581,404,24,18,6,91,50,41,66,44,22,55,41,14,115,76,39,209,139,70,205,130,75,146,60,86,74,23,51
Myeongil 1(il)-dong,Gangdong-gu,826.0,459,367,10,5,5,49,30,19,49,32,17,58,42,16,91,61,30,175,111,64,163,101,62,145,57,88,86,20,66
Myeongil 2(i)-dong,Gangdong-gu,501.0,287,214,2,2,-,27,17,10,27,18,9,33,21,12,66,39,27,107,74,33,88,56,32,94,46,48,57,14,43
Godeok 1(il)-dong,Gangdong-gu,587.0,346,241,12,7,5,35,24,11,29,23,6,49,37,12,80,55,25,123,81,42,96,59,37,103,40,63,60,20,40
Godeok 2(i)-dong,Gangdong-gu,932.0,566,366,10,8,2,30,16,14,42,28,14,72,49,23,161,118,43,240,167,73,167,97,70,148,67,81,62,16,46
Amsa 2(i)-dong,Gangdong-gu,499.0,313,186,7,4,3,20,15,5,15,12,3,38,26,12,61,51,10,101,67,34,112,62,50,103,59,44,42,17,25
Amsa 3(sam)-dong,Gangdong-gu,554.0,331,223,28,17,11,49,26,23,34,25,9,33,22,11,62,48,14,108,74,34,116,71,45,75,35,40,49,13,36
Cheonho 1(il)-dong,Gangdong-gu,1373.0,826,547,11,10,1,37,21,16,61,44,17,106,73,33,180,123,57,353,239,114,311,180,131,228,112,116,86,24,62
Cheonho 3(sam)-dong,Gangdong-gu,1303.0,776,527,11,10,1,25,16,9,58,39,19,103,68,35,144,99,45,317,211,106,326,186,140,247,124,123,72,23,49
Seongnae 1(il)-dong,Gangdong-gu,573.0,345,228,9,6,3,26,20,6,29,19,10,47,31,16,75,55,20,122,80,42,136,72,64,101,56,45,28,6,22
Seongnae 2(i)-dong,Gangdong-gu,1163.0,698,465,15,13,2,22,12,10,44,29,15,86,60,26,130,95,35,264,176,88,289,173,116,242,119,123,71,21,50
Seongnae 3(sam)-dong,Gangdong-gu,892.0,542,350,6,3,3,25,16,9,33,26,7,85,70,15,104,72,32,204,136,68,214,129,85,155,69,86,66,21,45
Dunchon 1(il)-dong,Gangdong-gu,442.0,248,194,5,3,2,21,17,4,23,13,10,28,22,6,60,40,20,96,59,37,90,56,34,70,28,42,49,10,39
Dunchon 2(i)-dong,Gangdong-gu,962.0,566,396,15,8,7,37,22,15,41,29,12,59,42,17,106,83,23,214,141,73,205,127,78,192,85,107,93,29,64
Amsa 1(il)-dong,Gangdong-gu,1599.0,950,649,15,11,4,45,29,16,74,53,21,120,81,39,208,145,63,361,236,125,363,218,145,311,153,158,102,24,78
Cheonho 2(i)-dong,Gangdong-gu,1798.0,1097,701,13,8,5,56,37,19,68,45,23,146,101,45,262,188,74,429,296,133,377,224,153,338,171,167,109,27,82
Gil-dong,Gangdong-gu,1958.0,1197,761,21,16,5,61,42,19,87,66,21,185,133,52,234,163,71,459,293,166,467,289,178,316,146,170,128,49,79
